"order_id","sales","profit","quantity","category","sub_category","Cost","Total_Cost","Total_profit"
AZ-2011-1029887,85,15,2,Furniture,Furnishings,70,70,30
AZ-2011-1029887,26,7,2,Office Supplies,Labels,19,19,14
AZ-2011-107716,294,109,7,Technology,Accessories,185,185,763
AZ-2011-1087704,76,11,3,Furniture,Furnishings,65,65,33
AZ-2011-1087704,252,15,5,Office Supplies,Binders,237,237,75
AZ-2011-1087704,90,17,3,Office Supplies,Supplies,73,73,51
AZ-2011-1114253,1334,200,8,Technology,Phones,1134,1134,1600
AZ-2011-1116129,32,6,3,Office Supplies,Labels,26,26,18
AZ-2011-1137571,88,3,2,Furniture,Furnishings,85,85,6
AZ-2011-1137571,284,43,5,Office Supplies,Art,241,241,215
AZ-2011-1174243,541,156,4,Furniture,Bookcases,385,385,624
AZ-2011-122598,576,51,5,Office Supplies,Storage,525,525,255
AZ-2011-1229073,307,99,5,Furniture,Chairs,208,208,495
AZ-2011-1229073,44,14,3,Office Supplies,Binders,30,30,42
AZ-2011-1229073,96,21,4,Office Supplies,Supplies,75,75,84
AZ-2011-1240916,152,44,2,Office Supplies,Appliances,108,108,88
AZ-2011-1240916,957,316,12,Technology,Phones,641,641,3792
AZ-2011-1253407,87,-78,3,Furniture,Chairs,165,165,-234
AZ-2011-1260928,33,10,3,Office Supplies,Binders,23,23,30
AZ-2011-1278696,28,10,2,Office Supplies,Fasteners,18,18,20
AZ-2011-1279238,25,-11,4,Office Supplies,Art,36,36,-44
AZ-2011-1279238,82,-74,3,Office Supplies,Storage,156,156,-222
AZ-2011-130330,38,11,2,Furniture,Furnishings,27,27,22
AZ-2011-1315772,13,3,2,Office Supplies,Binders,10,10,6
AZ-2011-1315772,748,283,4,Office Supplies,Storage,465,465,1132
AZ-2011-1315772,800,168,3,Technology,Machines,632,632,504
AZ-2011-1315772,1908,820,3,Technology,Phones,1088,1088,2460
AZ-2011-1322840,630,132,5,Furniture,Bookcases,498,498,660
AZ-2011-1328316,46,8,3,Office Supplies,Art,38,38,24
AZ-2011-1328316,636,140,1,Technology,Phones,496,496,140
AZ-2011-1331897,266,58,10,Office Supplies,Art,44,208,580
AZ-2011-1331897,10,2,2,Office Supplies,Binders,8,8,4
AZ-2011-1331897,54,8,5,Office Supplies,Labels,46,46,40
AZ-2011-1331897,255,-98,3,Office Supplies,Storage,353,353,-294
AZ-2011-1331897,666,66,9,Technology,Accessories,600,600,594
AZ-2011-1332474,56,-1,2,Office Supplies,Storage,57,57,-2
AZ-2011-1332474,442,0,3,Technology,Copiers,442,442,0
AZ-2011-1335871,241,24,2,Office Supplies,Storage,217,217,48
AZ-2011-1362199,164,-70,5,Furniture,Chairs,234,234,-350
AZ-2011-1362199,30,-10,3,Office Supplies,Art,40,40,-30
AZ-2011-1362199,20,-17,3,Office Supplies,Binders,37,37,-51
AZ-2011-1362591,176,65,4,Office Supplies,Supplies,111,111,260
AZ-2011-1366554,510,132,11,Office Supplies,Art,378,378,1452
AZ-2011-1366554,94,16,5,Office Supplies,Envelopes,78,78,80
AZ-2011-1372644,15,1,2,Office Supplies,Labels,14,14,2
AZ-2011-1406494,39,8,3,Office Supplies,Labels,31,31,24
AZ-2011-1406494,364,142,2,Technology,Phones,222,222,284
AZ-2011-1410648,18,3,2,Office Supplies,Binders,15,15,6
AZ-2011-144325,156,34,3,Furniture,Furnishings,122,122,102
AZ-2011-1445249,1667,185,6,Office Supplies,Appliances,1482,1482,1110
AZ-2011-1445249,98,12,2,Office Supplies,Binders,86,86,24
AZ-2011-1445262,23,8,1,Furniture,Furnishings,15,15,8
AZ-2011-145488,396,84,3,Furniture,Bookcases,312,312,252
AZ-2011-145488,130,44,5,Office Supplies,Art,86,86,220
AZ-2011-145488,8,2,1,Office Supplies,Labels,6,6,2
AZ-2011-145488,895,179,5,Office Supplies,Storage,716,716,895
AZ-2011-1474073,71,5,11,Office Supplies,Binders,23,66,55
AZ-2011-1475254,48,21,2,Office Supplies,Storage,27,27,42
AZ-2011-1484679,273,14,5,Office Supplies,Storage,259,259,70
AZ-2011-1499597,141,24,2,Office Supplies,Appliances,117,117,48
AZ-2011-1499597,69,26,5,Office Supplies,Binders,43,43,130
AZ-2011-1499597,176,39,4,Office Supplies,Supplies,137,137,156
AZ-2011-1499597,370,0,5,Technology,Phones,370,370,0
AZ-2011-1536006,66,2,5,Office Supplies,Binders,64,64,10
AZ-2011-1546153,169,32,7,Office Supplies,Art,137,137,224
AZ-2011-1546153,625,6,2,Technology,Machines,619,619,12
AZ-2011-1584049,147,-15,2,Furniture,Chairs,162,162,-30
AZ-2011-1584049,336,114,2,Technology,Copiers,222,222,228
AZ-2011-1584049,59,8,1,Technology,Phones,51,51,8
AZ-2011-1584987,178,28,4,Office Supplies,Storage,150,150,112
AZ-2011-1589827,465,19,6,Office Supplies,Appliances,446,446,114
AZ-2011-1589827,48,8,2,Office Supplies,Paper,13,40,16
AZ-2011-1603295,623,69,5,Furniture,Chairs,554,554,345
AZ-2011-1645475,622,19,2,Office Supplies,Appliances,603,603,38
AZ-2011-1655349,58,26,2,Office Supplies,Binders,32,32,52
AZ-2011-1655349,140,8,6,Office Supplies,Envelopes,132,132,48
AZ-2011-1661180,136,41,3,Office Supplies,Paper,95,95,123
AZ-2011-1672552,162,73,2,Technology,Machines,89,89,146
AZ-2011-1680940,270,75,3,Furniture,Chairs,195,195,225
AZ-2011-1693949,1207,36,4,Technology,Machines,1171,1171,144
AZ-2011-1722024,34,14,2,Office Supplies,Art,20,20,28
AZ-2011-1723003,103,36,2,Office Supplies,Binders,67,67,72
AZ-2011-1735855,31,9,2,Office Supplies,Binders,22,22,18
AZ-2011-1754604,67,28,3,Office Supplies,Supplies,39,39,84
AZ-2011-176674,172,48,2,Office Supplies,Appliances,124,124,96
AZ-2011-176674,275,49,5,Office Supplies,Art,226,226,245
AZ-2011-177100,527,132,2,Technology,Copiers,395,395,264
AZ-2011-1773848,76,31,5,Office Supplies,Storage,45,45,155
AZ-2011-1776203,45,16,3,Office Supplies,Art,29,29,48
AZ-2011-1816950,26,-11,1,Office Supplies,Binders,37,37,-11
AZ-2011-1845681,84,41,4,Office Supplies,Paper,43,43,164
AZ-2011-1868249,777,129,7,Technology,Phones,648,648,903
AZ-2011-1890132,51,14,2,Office Supplies,Art,37,37,28
AZ-2011-1902971,600,77,4,Furniture,Bookcases,105,523,308
AZ-2011-1902971,395,120,9,Office Supplies,Binders,38,275,1080
AZ-2011-1916360,288,20,2,Furniture,Bookcases,268,268,40
AZ-2011-1916555,61,7,6,Office Supplies,Storage,54,54,42
AZ-2011-1930058,71,1,3,Office Supplies,Art,70,70,3
AZ-2011-1967754,132,54,5,Office Supplies,Art,78,78,270
AZ-2011-1967754,93,40,2,Technology,Accessories,53,53,80
AZ-2011-1976919,97,12,2,Office Supplies,Binders,85,85,24
AZ-2011-2001312,52,19,4,Office Supplies,Envelopes,33,33,76
AZ-2011-2001312,136,15,4,Office Supplies,Paper,121,121,60
AZ-2011-2002251,58,8,2,Office Supplies,Art,50,50,16
AZ-2011-201891,32,10,3,Office Supplies,Labels,22,22,30
AZ-2011-2030946,144,35,3,Office Supplies,Appliances,109,109,105
AZ-2011-2030946,41,1,2,Office Supplies,Storage,40,40,2
AZ-2011-2079755,990,149,5,Furniture,Bookcases,841,841,745
AZ-2011-2079755,17,7,2,Office Supplies,Fasteners,10,10,14
AZ-2011-209146,152,49,3,Office Supplies,Art,103,103,147
AZ-2011-2099050,46,8,3,Office Supplies,Art,38,38,24
AZ-2011-2099050,116,42,5,Office Supplies,Paper,25,74,210
AZ-2011-2099050,359,179,3,Technology,Copiers,180,180,537
AZ-2011-2112563,51,18,3,Office Supplies,Art,33,33,54
AZ-2011-2112563,292,87,4,Technology,Machines,150,205,348
AZ-2011-211681,1036,321,6,Furniture,Bookcases,715,715,1926
AZ-2011-211681,26,10,2,Office Supplies,Binders,16,16,20
AZ-2011-2118516,230,81,6,Office Supplies,Paper,49,149,486
AZ-2011-2118516,53,22,2,Office Supplies,Supplies,31,31,44
AZ-2011-2141552,82,3,3,Office Supplies,Supplies,79,79,9
AZ-2011-2143841,289,48,3,Furniture,Furnishings,241,241,144
AZ-2011-2143841,91,30,8,Office Supplies,Binders,8,61,240
AZ-2011-2143841,113,-13,3,Technology,Accessories,126,126,-39
AZ-2011-2143841,860,0,3,Technology,Copiers,860,860,0
AZ-2011-2148580,65,25,1,Technology,Phones,40,40,25
AZ-2011-2169445,47,7,7,Office Supplies,Labels,40,40,49
AZ-2011-2169445,105,42,3,Office Supplies,Supplies,63,63,126
AZ-2011-2169445,82,14,2,Technology,Phones,68,68,28
AZ-2011-2179552,1266,323,3,Furniture,Tables,943,943,969
AZ-2011-2189408,194,73,3,Technology,Phones,121,121,219
AZ-2011-2201547,94,14,7,Office Supplies,Paper,80,80,98
AZ-2011-2201547,194,0,4,Office Supplies,Storage,194,194,0
AZ-2011-2202582,152,7,2,Furniture,Chairs,145,145,14
AZ-2011-2222024,34,-6,2,Office Supplies,Paper,40,40,-12
AZ-2011-2223205,113,25,2,Office Supplies,Storage,88,88,50
AZ-2011-2245674,12,3,2,Office Supplies,Binders,9,9,6
AZ-2011-2245674,666,120,5,Office Supplies,Storage,546,546,600
AZ-2011-2270958,1003,-943,4,Furniture,Tables,1946,1946,-3772
AZ-2011-2270958,164,78,3,Office Supplies,Art,86,86,234
AZ-2011-2270958,29,-13,1,Office Supplies,Storage,42,42,-13
AZ-2011-2270958,30,-5,1,Technology,Machines,35,35,-5
AZ-2011-2273790,185,17,7,Office Supplies,Art,168,168,119
AZ-2011-2273790,155,28,3,Office Supplies,Binders,127,127,84
AZ-2011-231889,36,12,2,Office Supplies,Art,24,24,24
AZ-2011-2320734,13,2,1,Office Supplies,Paper,11,11,2
AZ-2011-2369759,25,10,2,Office Supplies,Fasteners,15,15,20
AZ-2011-2369759,72,4,2,Technology,Machines,68,68,8
AZ-2011-2389500,554,144,12,Office Supplies,Supplies,410,410,1728
AZ-2011-2397035,112,4,4,Office Supplies,Art,108,108,16
AZ-2011-2397035,50,6,4,Office Supplies,Binders,44,44,24
AZ-2011-2397035,208,12,2,Technology,Machines,196,196,24
AZ-2011-2437108,24,10,2,Office Supplies,Art,14,14,20
AZ-2011-2437108,104,16,2,Office Supplies,Storage,88,88,32
AZ-2011-2445910,85,-33,1,Office Supplies,Storage,118,118,-33
AZ-2011-2459767,118,41,4,Office Supplies,Art,77,77,164
AZ-2011-2523831,44,10,3,Office Supplies,Art,34,34,30
AZ-2011-252578,39,10,6,Office Supplies,Binders,29,29,60
AZ-2011-252578,444,89,4,Technology,Phones,355,355,356
AZ-2011-2536125,31,13,4,Office Supplies,Binders,18,18,52
AZ-2011-2536125,47,21,3,Office Supplies,Envelopes,26,26,63
AZ-2011-2536125,40,18,2,Office Supplies,Fasteners,22,22,36
AZ-2011-2536125,102,-25,3,Office Supplies,Storage,127,127,-75
AZ-2011-254910,83,10,2,Office Supplies,Supplies,73,73,20
AZ-2011-2564570,145,17,3,Office Supplies,Binders,128,128,51
AZ-2011-2571428,445,124,9,Office Supplies,Art,321,321,1116
AZ-2011-2571428,136,13,5,Office Supplies,Binders,123,123,65
AZ-2011-2571428,115,37,3,Office Supplies,Storage,78,78,111
AZ-2011-257509,257,108,1,Technology,Accessories,149,149,108
AZ-2011-2598415,713,40,4,Furniture,Bookcases,673,673,160
AZ-2011-2598415,827,-395,4,Furniture,Tables,1222,1222,-1580
AZ-2011-2598415,324,-25,6,Office Supplies,Appliances,349,349,-150
AZ-2011-2598415,185,44,11,Office Supplies,Binders,111,141,484
AZ-2011-259939,654,247,2,Furniture,Bookcases,407,407,494
AZ-2011-259939,17,0,1,Office Supplies,Paper,17,17,0
AZ-2011-259939,169,38,3,Office Supplies,Storage,131,131,114
AZ-2011-259939,862,198,5,Technology,Machines,664,664,990
AZ-2011-2606042,133,5,5,Office Supplies,Art,128,128,25
AZ-2011-2606042,80,21,7,Office Supplies,Binders,59,59,147
AZ-2011-2627856,41,18,4,Office Supplies,Art,23,23,72
AZ-2011-2669880,112,-3,2,Office Supplies,Storage,115,115,-6
AZ-2011-2669880,1894,701,5,Technology,Copiers,1193,1193,3505
AZ-2011-2669941,161,80,5,Office Supplies,Art,81,81,400
AZ-2011-2690707,56,0,2,Office Supplies,Binders,56,56,0
AZ-2011-2690707,47,18,2,Office Supplies,Envelopes,29,29,36
AZ-2011-269617,41,12,3,Office Supplies,Binders,29,29,36
AZ-2011-2730322,293,146,6,Furniture,Furnishings,147,147,876
AZ-2011-2730322,77,2,2,Office Supplies,Appliances,75,75,4
AZ-2011-2730322,85,36,5,Office Supplies,Art,49,49,180
AZ-2011-2730322,276,16,7,Office Supplies,Supplies,260,260,112
AZ-2011-2730322,1292,-137,4,Technology,Copiers,1429,1429,-548
AZ-2011-2730322,361,132,5,Technology,Machines,229,229,660
AZ-2011-2730322,568,73,4,Technology,Phones,495,495,292
AZ-2011-2748688,51,17,2,Office Supplies,Art,34,34,34
AZ-2011-2750871,50,25,5,Office Supplies,Art,25,25,125
AZ-2011-2762983,538,221,7,Office Supplies,Appliances,317,317,1547
AZ-2011-2762983,119,38,9,Office Supplies,Art,81,81,342
AZ-2011-2762983,48,6,2,Office Supplies,Envelopes,42,42,12
AZ-2011-2762983,493,185,11,Office Supplies,Storage,229,308,2035
AZ-2011-2777408,147,0,12,Office Supplies,Art,147,147,0
AZ-2011-2777408,102,35,2,Office Supplies,Storage,67,67,70
AZ-2011-2777408,47,13,1,Technology,Machines,34,34,13
AZ-2011-2787690,1236,302,3,Furniture,Chairs,934,934,906
AZ-2011-2792664,599,0,2,Technology,Copiers,599,599,0
AZ-2011-2820672,212,70,2,Technology,Phones,142,142,140
AZ-2011-2825684,33,15,5,Office Supplies,Binders,10,18,75
AZ-2011-2831492,43,11,6,Office Supplies,Labels,32,32,66
AZ-2011-2847355,76,2,5,Office Supplies,Supplies,74,74,10
AZ-2011-2851167,32,7,3,Office Supplies,Binders,25,25,21
AZ-2011-2859436,304,97,6,Office Supplies,Art,207,207,582
AZ-2011-2859436,115,2,3,Technology,Machines,113,113,6
AZ-2011-2875746,79,35,5,Office Supplies,Envelopes,44,44,175
AZ-2011-2881763,70,22,3,Furniture,Furnishings,48,48,66
AZ-2011-2884922,17,2,2,Office Supplies,Labels,15,15,4
AZ-2011-2892090,135,63,1,Office Supplies,Storage,72,72,63
AZ-2011-2892090,191,48,1,Technology,Copiers,143,143,48
AZ-2011-2905039,1234,370,3,Furniture,Chairs,864,864,1110
AZ-2011-2918397,155,36,1,Furniture,Bookcases,119,119,36
AZ-2011-2918397,33,2,3,Office Supplies,Fasteners,31,31,6
AZ-2011-2918397,716,143,4,Office Supplies,Storage,573,573,572
AZ-2011-2939440,117,31,12,Office Supplies,Fasteners,47,86,372
AZ-2011-2948812,237,83,8,Office Supplies,Art,154,154,664
AZ-2011-2948812,104,25,9,Office Supplies,Binders,79,79,225
AZ-2011-2948812,58,27,3,Office Supplies,Fasteners,31,31,81
AZ-2011-2948812,29,9,3,Office Supplies,Storage,20,20,27
AZ-2011-2948812,104,0,3,Office Supplies,Supplies,104,104,0
AZ-2011-2948812,578,129,4,Technology,Machines,449,449,516
AZ-2011-2956456,110,22,6,Office Supplies,Fasteners,88,88,132
AZ-2011-297789,59,21,2,Office Supplies,Art,38,38,42
AZ-2011-297789,46,19,3,Office Supplies,Storage,27,27,57
AZ-2011-2986519,964,231,5,Technology,Copiers,733,733,1155
AZ-2011-2986519,351,84,3,Technology,Machines,267,267,252
AZ-2011-3004709,1108,326,2,Technology,Phones,782,782,652
AZ-2011-3004753,147,53,3,Office Supplies,Binders,94,94,159
AZ-2011-3020021,2053,410,4,Office Supplies,Appliances,1643,1643,1640
AZ-2011-3020021,57,4,3,Office Supplies,Paper,53,53,12
AZ-2011-3059419,48,21,3,Office Supplies,Envelopes,27,27,63
AZ-2011-3081666,57,25,3,Furniture,Furnishings,32,32,75
AZ-2011-3089735,1889,483,7,Office Supplies,Appliances,1406,1406,3381
AZ-2011-3089735,498,139,10,Office Supplies,Binders,359,359,1390
AZ-2011-3096034,41,4,4,Office Supplies,Labels,37,37,16
AZ-2011-3096034,91,35,2,Technology,Accessories,56,56,70
AZ-2011-309750,457,59,9,Office Supplies,Art,398,398,531
AZ-2011-309750,253,86,9,Office Supplies,Paper,152,167,774
AZ-2011-3101381,32,8,5,Office Supplies,Binders,24,24,40
AZ-2011-310635,63,26,2,Office Supplies,Binders,37,37,52
AZ-2011-310635,605,266,5,Technology,Machines,339,339,1330
AZ-2011-3114201,37,8,4,Office Supplies,Storage,29,29,32
AZ-2011-3117259,249,70,6,Technology,Machines,179,179,420
AZ-2011-3120181,114,17,2,Office Supplies,Art,97,97,34
AZ-2011-3120181,120,26,5,Office Supplies,Supplies,94,94,130
AZ-2011-3127133,311,68,6,Furniture,Furnishings,243,243,408
AZ-2011-3127133,34,9,3,Office Supplies,Binders,25,25,27
AZ-2011-3149617,999,70,4,Technology,Copiers,929,929,280
AZ-2011-3182961,15,5,2,Office Supplies,Binders,10,10,10
AZ-2011-3182961,1469,308,5,Technology,Copiers,1161,1161,1540
AZ-2011-3190941,97,37,3,Office Supplies,Art,60,60,111
AZ-2011-3190941,94,21,2,Office Supplies,Envelopes,73,73,42
AZ-2011-3190941,104,27,5,Office Supplies,Storage,77,77,135
AZ-2011-3190941,126,59,1,Technology,Copiers,67,67,59
AZ-2011-3213049,742,59,3,Technology,Accessories,683,683,177
AZ-2011-3223139,215,17,3,Furniture,Chairs,198,198,51
AZ-2011-3223139,59,29,2,Office Supplies,Envelopes,30,30,58
AZ-2011-3227418,469,78,3,Furniture,Bookcases,391,391,234
AZ-2011-3227418,6,2,1,Office Supplies,Binders,4,4,2
AZ-2011-3227418,336,30,2,Technology,Phones,306,306,60
AZ-2011-3234061,154,14,3,Office Supplies,Binders,140,140,42
AZ-2011-3234061,85,36,3,Office Supplies,Paper,49,49,108
AZ-2011-3247022,608,189,4,Furniture,Bookcases,419,419,756
AZ-2011-3247022,159,14,8,Office Supplies,Art,145,145,112
AZ-2011-3247022,123,4,5,Office Supplies,Binders,119,119,20
AZ-2011-3247022,255,45,2,Office Supplies,Storage,210,210,90
AZ-2011-3252710,12,1,3,Office Supplies,Binders,11,11,3
AZ-2011-3252710,1508,332,4,Technology,Copiers,1176,1176,1328
AZ-2011-3293357,15,1,2,Office Supplies,Labels,14,14,2
AZ-2011-3293357,47,17,2,Office Supplies,Paper,30,30,34
AZ-2011-3304186,57,14,3,Office Supplies,Art,43,43,42
AZ-2011-3304186,24,1,2,Office Supplies,Binders,23,23,2
AZ-2011-3304186,39,18,2,Office Supplies,Fasteners,21,21,36
AZ-2011-3304186,242,10,5,Office Supplies,Paper,232,232,50
AZ-2011-3304186,533,-275,8,Office Supplies,Storage,713,808,-2200
AZ-2011-3304186,312,12,12,Technology,Accessories,300,300,144
AZ-2011-3308302,131,4,3,Office Supplies,Storage,127,127,12
AZ-2011-3308302,152,12,8,Office Supplies,Supplies,140,140,96
AZ-2011-3308302,222,60,4,Technology,Phones,162,162,240
AZ-2011-332801,83,12,3,Office Supplies,Art,71,71,36
AZ-2011-3348631,534,232,3,Office Supplies,Storage,302,302,696
AZ-2011-3348631,99,29,2,Technology,Machines,70,70,58
AZ-2011-3348631,533,112,7,Technology,Phones,421,421,784
AZ-2011-3378761,307,82,2,Furniture,Bookcases,225,225,164
AZ-2011-3378761,155,56,3,Furniture,Furnishings,99,99,168
AZ-2011-3378761,282,70,8,Office Supplies,Binders,79,212,560
AZ-2011-3378761,583,245,7,Technology,Machines,338,338,1715
AZ-2011-3378761,773,46,5,Technology,Phones,727,727,230
AZ-2011-340357,106,22,11,Office Supplies,Labels,23,84,242
AZ-2011-3434177,1059,106,6,Furniture,Chairs,953,953,636
AZ-2011-3434177,87,27,2,Furniture,Furnishings,60,60,54
AZ-2011-3434177,965,125,7,Office Supplies,Storage,840,840,875
AZ-2011-3485437,21,5,2,Office Supplies,Binders,16,16,10
AZ-2011-3485437,88,40,4,Office Supplies,Paper,48,48,160
AZ-2011-3485437,87,41,2,Office Supplies,Supplies,46,46,82
AZ-2011-3509727,1796,844,7,Technology,Accessories,952,952,5908
AZ-2011-3515834,22,7,2,Office Supplies,Binders,15,15,14
AZ-2011-3535148,34,8,3,Office Supplies,Art,26,26,24
AZ-2011-3556179,770,85,7,Furniture,Furnishings,685,685,595
AZ-2011-3556179,193,8,4,Office Supplies,Paper,185,185,32
AZ-2011-3586083,69,18,1,Office Supplies,Appliances,51,51,18
AZ-2011-3586083,144,65,5,Office Supplies,Binders,79,79,325
AZ-2011-3586083,22,1,1,Office Supplies,Supplies,21,21,1
AZ-2011-3640757,36,15,3,Office Supplies,Art,21,21,45
AZ-2011-3674097,503,166,11,Office Supplies,Envelopes,337,337,1826
AZ-2011-3674097,28,13,3,Office Supplies,Labels,15,15,39
AZ-2011-3706904,129,27,4,Office Supplies,Art,33,102,108
AZ-2011-3714764,72,14,3,Office Supplies,Art,58,58,42
AZ-2011-3755505,286,83,2,Furniture,Bookcases,203,203,166
AZ-2011-3755505,205,80,3,Furniture,Chairs,125,125,240
AZ-2011-3755505,88,27,2,Furniture,Furnishings,61,61,54
AZ-2011-3755505,137,63,3,Office Supplies,Art,74,74,189
AZ-2011-3755505,45,2,2,Office Supplies,Paper,43,43,4
AZ-2011-3755505,1593,653,5,Technology,Copiers,940,940,3265
AZ-2011-3810756,170,32,1,Technology,Phones,138,138,32
AZ-2011-3828424,268,24,2,Office Supplies,Storage,244,244,48
AZ-2011-3828424,565,57,4,Technology,Phones,508,508,228
AZ-2011-3828805,168,56,3,Office Supplies,Storage,112,112,168
AZ-2011-3846849,512,210,9,Office Supplies,Storage,302,302,1890
AZ-2011-3846849,1256,243,18,Technology,Accessories,621,1013,4374
AZ-2011-3858939,116,38,8,Office Supplies,Art,78,78,304
AZ-2011-3858939,36,5,4,Office Supplies,Labels,31,31,20
AZ-2011-3858939,90,30,2,Office Supplies,Supplies,60,60,60
AZ-2011-3885003,257,74,5,Furniture,Furnishings,183,183,370
AZ-2011-3885003,44,8,2,Office Supplies,Art,36,36,16
AZ-2011-3885003,64,25,9,Office Supplies,Labels,39,39,225
AZ-2011-3885003,785,86,3,Technology,Copiers,699,699,258
AZ-2011-3885003,306,9,2,Technology,Phones,297,297,18
AZ-2011-3901505,89,31,3,Office Supplies,Art,58,58,93
AZ-2011-3903564,44,20,2,Office Supplies,Envelopes,24,24,40
AZ-2011-3921026,113,56,1,Technology,Accessories,57,57,56
AZ-2011-3921026,455,-64,2,Technology,Machines,519,519,-128
AZ-2011-3930237,17,4,1,Office Supplies,Fasteners,13,13,4
AZ-2011-3937280,76,9,4,Furniture,Furnishings,67,67,36
AZ-2011-3937280,80,34,3,Office Supplies,Supplies,46,46,102
AZ-2011-3958316,65,20,5,Office Supplies,Binders,45,45,100
AZ-2011-3958316,1241,138,7,Office Supplies,Storage,1103,1103,966
AZ-2011-3963408,151,5,3,Furniture,Furnishings,146,146,15
AZ-2011-3973701,34,0,3,Office Supplies,Fasteners,34,34,0
AZ-2011-3976238,1622,534,3,Technology,Phones,1088,1088,1602
AZ-2011-3981757,29,6,2,Office Supplies,Art,23,23,12
AZ-2011-3982438,13,5,1,Office Supplies,Envelopes,8,8,5
AZ-2011-3989901,40,17,5,Office Supplies,Binders,23,23,85
AZ-2011-3998709,95,2,5,Office Supplies,Fasteners,93,93,10
AZ-2011-3999419,194,70,4,Office Supplies,Storage,124,124,280
AZ-2011-4069925,107,30,4,Office Supplies,Art,77,77,120
AZ-2011-4072657,103,30,2,Furniture,Furnishings,73,73,60
AZ-2011-4072657,132,61,6,Office Supplies,Paper,71,71,366
AZ-2011-4072657,124,41,1,Office Supplies,Storage,83,83,41
AZ-2011-4087409,2056,391,5,Furniture,Bookcases,1665,1665,1955
AZ-2011-4159708,16,0,1,Office Supplies,Binders,16,16,0
AZ-2011-4173505,66,19,1,Furniture,Chairs,47,47,19
AZ-2011-4173505,151,43,7,Office Supplies,Art,50,108,301
AZ-2011-4173505,45,6,4,Office Supplies,Binders,16,39,24
AZ-2011-4205736,20,4,1,Furniture,Furnishings,16,16,4
AZ-2011-4205736,133,4,10,Office Supplies,Binders,129,129,40
AZ-2011-4229445,636,273,1,Technology,Phones,363,363,273
AZ-2011-4234441,187,41,3,Furniture,Chairs,146,146,123
AZ-2011-4342621,56,6,2,Office Supplies,Art,50,50,12
AZ-2011-4342621,201,76,15,Office Supplies,Binders,32,125,1140
AZ-2011-4342621,79,32,3,Office Supplies,Storage,47,47,96
AZ-2011-4342621,89,28,4,Office Supplies,Supplies,61,61,112
AZ-2011-4342621,282,76,2,Technology,Copiers,206,206,152
AZ-2011-438758,230,5,2,Office Supplies,Storage,225,225,10
AZ-2011-438758,103,40,3,Office Supplies,Supplies,63,63,120
AZ-2011-4432302,116,21,2,Furniture,Furnishings,95,95,42
AZ-2011-4442288,122,50,7,Office Supplies,Art,72,72,350
AZ-2011-4452827,89,15,3,Office Supplies,Binders,74,74,45
AZ-2011-4452827,144,13,3,Office Supplies,Supplies,131,131,39
AZ-2011-4460165,38,9,2,Office Supplies,Art,29,29,18
AZ-2011-4495779,426,68,3,Office Supplies,Storage,358,358,204
AZ-2011-4501299,146,26,3,Office Supplies,Art,120,120,78
AZ-2011-4501299,9,2,1,Office Supplies,Binders,7,7,2
AZ-2011-4565223,93,45,5,Office Supplies,Fasteners,48,48,225
AZ-2011-4599404,146,7,5,Office Supplies,Art,139,139,35
AZ-2011-4612792,195,91,4,Office Supplies,Art,104,104,364
AZ-2011-4613853,13,2,1,Office Supplies,Binders,11,11,2
AZ-2011-4614904,44,8,2,Office Supplies,Art,36,36,16
AZ-2011-4696725,162,43,2,Technology,Phones,119,119,86
AZ-2011-4704797,259,-55,2,Furniture,Chairs,314,314,-110
AZ-2011-4704797,55,10,1,Office Supplies,Art,45,45,10
AZ-2011-4707711,57,5,3,Office Supplies,Fasteners,52,52,15
AZ-2011-4735956,88,22,2,Office Supplies,Storage,66,66,44
AZ-2011-4743912,332,55,3,Furniture,Bookcases,277,277,165
AZ-2011-4763989,590,260,3,Furniture,Bookcases,330,330,780
AZ-2011-4764378,239,96,8,Office Supplies,Binders,143,143,768
AZ-2011-4764378,187,15,1,Office Supplies,Storage,172,172,15
AZ-2011-4765625,60,10,2,Office Supplies,Art,50,50,20
AZ-2011-4765625,170,69,5,Office Supplies,Paper,101,101,345
AZ-2011-4765625,1630,594,6,Technology,Copiers,1036,1036,3564
AZ-2011-479838,2118,441,7,Furniture,Bookcases,196,1677,3087
AZ-2011-479838,34,12,2,Office Supplies,Envelopes,22,22,24
AZ-2011-4802355,261,15,6,Furniture,Furnishings,38,246,90
AZ-2011-4802639,145,36,3,Furniture,Chairs,109,109,108
AZ-2011-4802639,50,9,3,Office Supplies,Paper,41,41,27
AZ-2011-4802639,51,9,3,Office Supplies,Storage,42,42,27
AZ-2011-4818219,616,142,3,Furniture,Tables,474,474,426
AZ-2011-4827146,55,10,1,Office Supplies,Art,45,45,10
AZ-2011-4827146,97,31,2,Office Supplies,Storage,66,66,62
AZ-2011-4835209,100,33,6,Office Supplies,Fasteners,67,67,198
AZ-2011-4865633,143,44,2,Technology,Machines,99,99,88
AZ-2011-4872140,39,3,3,Office Supplies,Binders,36,36,9
AZ-2011-494581,78,20,3,Office Supplies,Art,58,58,60
AZ-2011-4946550,197,79,4,Office Supplies,Binders,118,118,316
AZ-2011-4946550,14,7,1,Office Supplies,Fasteners,7,7,7
AZ-2011-4951642,134,37,5,Office Supplies,Art,97,97,185
AZ-2011-4951642,27,4,2,Office Supplies,Binders,23,23,8
AZ-2011-496083,364,45,8,Office Supplies,Appliances,319,319,360
AZ-2011-496083,181,61,6,Office Supplies,Storage,39,120,366
AZ-2011-4987681,38,18,1,Office Supplies,Supplies,20,20,18
AZ-2011-4987681,587,104,1,Technology,Phones,483,483,104
AZ-2011-5002447,1029,-247,5,Furniture,Bookcases,1276,1276,-1235
AZ-2011-5002447,28,-10,2,Office Supplies,Binders,38,38,-20
AZ-2011-5002447,25,-6,1,Office Supplies,Envelopes,31,31,-6
AZ-2011-5004051,15,-9,2,Office Supplies,Art,24,24,-18
AZ-2011-5004051,7,-4,1,Office Supplies,Fasteners,11,11,-4
AZ-2011-5009632,96,25,8,Office Supplies,Binders,27,71,200
AZ-2011-5009632,40,0,3,Office Supplies,Labels,40,40,0
AZ-2011-5010109,178,59,7,Office Supplies,Art,119,119,413
AZ-2011-5023465,90,21,3,Office Supplies,Art,69,69,63
AZ-2011-5023465,28,10,2,Office Supplies,Fasteners,18,18,20
AZ-2011-5040391,439,117,4,Furniture,Bookcases,322,322,468
AZ-2011-504913,49,4,1,Furniture,Furnishings,45,45,4
AZ-2011-5059692,105,10,5,Office Supplies,Art,95,95,50
AZ-2011-5059692,5277,1759,9,Technology,Phones,3518,3518,15831
AZ-2011-5060005,126,-116,9,Office Supplies,Art,242,242,-1044
AZ-2011-5082038,237,35,7,Office Supplies,Paper,202,202,245
AZ-2011-5097391,36,3,2,Office Supplies,Art,33,33,6
AZ-2011-5098375,719,21,5,Furniture,Bookcases,698,698,105
AZ-2011-5098375,334,133,4,Office Supplies,Appliances,201,201,532
AZ-2011-5099606,299,113,2,Furniture,Bookcases,186,186,226
AZ-2011-5113507,178,-6,4,Furniture,Chairs,184,184,-24
AZ-2011-5113507,4590,523,14,Technology,Copiers,486,4067,7322
AZ-2011-512368,53,23,1,Office Supplies,Art,30,30,23
AZ-2011-5148757,50,14,3,Office Supplies,Binders,36,36,42
AZ-2011-5148757,160,67,6,Office Supplies,Supplies,93,93,402
AZ-2011-5170408,85,4,3,Office Supplies,Paper,81,81,12
AZ-2011-5185285,551,98,3,Office Supplies,Storage,453,453,294
AZ-2011-5195846,267,90,3,Furniture,Furnishings,177,177,270
AZ-2011-5195846,55,-19,4,Office Supplies,Envelopes,74,74,-76
AZ-2011-5195846,91,-2,3,Office Supplies,Storage,93,93,-6
AZ-2011-5228035,36,7,3,Office Supplies,Fasteners,29,29,21
AZ-2011-5263190,114,41,6,Office Supplies,Art,73,73,246
AZ-2011-5263190,374,141,2,Office Supplies,Storage,233,233,282
AZ-2011-5265175,1119,246,2,Office Supplies,Appliances,873,873,492
AZ-2011-5265250,14,4,3,Office Supplies,Labels,10,10,12
AZ-2011-5289752,82,20,2,Office Supplies,Envelopes,62,62,40
AZ-2011-5289752,224,35,2,Technology,Phones,189,189,70
AZ-2011-529480,80,33,6,Office Supplies,Binders,47,47,198
AZ-2011-5313166,6517,2476,12,Office Supplies,Appliances,4041,4041,29712
AZ-2011-5313166,457,76,9,Office Supplies,Storage,381,381,684
AZ-2011-5342265,145,44,3,Office Supplies,Binders,101,101,132
AZ-2011-5342265,48,8,3,Office Supplies,Storage,40,40,24
AZ-2011-5348577,54,12,2,Technology,Accessories,42,42,24
AZ-2011-5348577,538,36,3,Technology,Machines,502,502,108
AZ-2011-5348577,120,-22,3,Technology,Phones,142,142,-66
AZ-2011-5353512,728,80,2,Furniture,Bookcases,648,648,160
AZ-2011-5353512,405,20,3,Furniture,Chairs,385,385,60
AZ-2011-5353512,49,19,2,Office Supplies,Art,30,30,38
AZ-2011-5353512,27,11,2,Office Supplies,Binders,16,16,22
AZ-2011-5353512,636,178,1,Technology,Phones,458,458,178
AZ-2011-5357101,495,233,2,Technology,Accessories,262,262,466
AZ-2011-5376119,1674,686,5,Furniture,Tables,988,988,3430
AZ-2011-5420037,57,12,2,Office Supplies,Binders,45,45,24
AZ-2011-5422408,520,203,3,Technology,Phones,317,317,609
AZ-2011-5437243,78,7,4,Office Supplies,Binders,56,71,28
AZ-2011-5437243,95,42,4,Office Supplies,Storage,53,53,168
AZ-2011-5437243,97,31,3,Office Supplies,Supplies,66,66,93
AZ-2011-5463300,110,37,2,Furniture,Furnishings,73,73,74
AZ-2011-5463300,21,9,2,Office Supplies,Art,12,12,18
AZ-2011-5466756,53,15,2,Office Supplies,Art,38,38,30
AZ-2011-5466756,80,1,7,Office Supplies,Fasteners,79,79,7
AZ-2011-5466756,99,10,2,Office Supplies,Storage,89,89,20
AZ-2011-5466756,217,22,5,Technology,Accessories,195,195,110
AZ-2011-5471262,16,2,2,Office Supplies,Labels,14,14,4
AZ-2011-5476846,84,9,3,Office Supplies,Art,75,75,27
AZ-2011-5482172,66,11,4,Office Supplies,Paper,55,55,44
AZ-2011-5492852,22,0,2,Office Supplies,Storage,22,22,0
AZ-2011-5511380,161,80,5,Office Supplies,Art,81,81,400
AZ-2011-5511380,148,35,3,Office Supplies,Paper,113,113,105
AZ-2011-5511380,368,-16,2,Office Supplies,Storage,384,384,-32
AZ-2011-5511380,125,0,3,Technology,Accessories,125,125,0
AZ-2011-5517169,194,84,4,Office Supplies,Art,110,110,336
AZ-2011-5526022,44,1,1,Office Supplies,Storage,43,43,1
AZ-2011-555801,48,18,3,Office Supplies,Art,30,30,54
AZ-2011-555801,271,51,9,Office Supplies,Binders,220,220,459
AZ-2011-5582578,854,290,7,Furniture,Bookcases,564,564,2030
AZ-2011-5582578,438,175,7,Office Supplies,Appliances,263,263,1225
AZ-2011-5582578,31,0,1,Office Supplies,Paper,31,31,0
AZ-2011-5592307,166,76,10,Office Supplies,Paper,90,90,760
AZ-2011-5608865,68,16,6,Office Supplies,Art,52,52,96
AZ-2011-5608865,148,16,3,Office Supplies,Binders,132,132,48
AZ-2011-5608865,23,8,2,Office Supplies,Supplies,15,15,16
AZ-2011-5663696,690,138,8,Technology,Machines,552,552,1104
AZ-2011-5663696,547,55,4,Technology,Phones,492,492,220
AZ-2011-5676694,822,353,2,Furniture,Bookcases,469,469,706
AZ-2011-5676694,19,4,1,Office Supplies,Art,15,15,4
AZ-2011-5690380,159,65,6,Office Supplies,Storage,94,94,390
AZ-2011-5702370,552,165,5,Furniture,Bookcases,387,387,825
AZ-2011-5702370,257,49,5,Office Supplies,Art,208,208,245
AZ-2011-5702370,17,6,2,Office Supplies,Binders,11,11,12
AZ-2011-5702370,522,21,2,Technology,Machines,501,501,42
AZ-2011-5707449,114,34,2,Office Supplies,Appliances,80,80,68
AZ-2011-5707449,118,0,4,Office Supplies,Art,118,118,0
AZ-2011-5707449,32,4,4,Office Supplies,Labels,28,28,16
AZ-2011-5707449,111,-61,3,Office Supplies,Storage,172,172,-183
AZ-2011-5707449,48,-20,2,Technology,Machines,68,68,-40
AZ-2011-5708655,65,25,5,Office Supplies,Binders,8,40,125
AZ-2011-5708655,88,18,3,Technology,Accessories,70,70,54
AZ-2011-5720864,41,11,6,Office Supplies,Binders,30,30,66
AZ-2011-5720864,117,56,7,Office Supplies,Fasteners,61,61,392
AZ-2011-5720864,716,150,7,Technology,Accessories,566,566,1050
AZ-2011-5721905,17,7,2,Office Supplies,Fasteners,10,10,14
AZ-2011-578089,749,180,7,Furniture,Furnishings,569,569,1260
AZ-2011-5788290,26,5,1,Office Supplies,Paper,21,21,5
AZ-2011-5801302,190,52,4,Office Supplies,Art,17,138,208
AZ-2011-5817638,584,234,7,Office Supplies,Appliances,350,350,1638
AZ-2011-5822789,108,37,2,Office Supplies,Art,71,71,74
AZ-2011-5827692,628,6,2,Technology,Machines,622,622,12
AZ-2011-583228,88,19,2,Office Supplies,Supplies,69,69,38
AZ-2011-5869323,54,12,2,Technology,Accessories,42,42,24
AZ-2011-5917724,512,227,1,Office Supplies,Appliances,285,285,227
AZ-2011-5917724,80,1,3,Office Supplies,Storage,79,79,3
AZ-2011-5942639,251,53,5,Office Supplies,Binders,198,198,265
AZ-2011-5942639,144,32,4,Office Supplies,Supplies,112,112,128
AZ-2011-5960662,224,103,11,Office Supplies,Paper,121,121,1133
AZ-2011-5960662,486,78,3,Technology,Machines,408,408,234
AZ-2011-5960662,440,66,6,Technology,Phones,374,374,396
AZ-2011-5965584,1569,185,7,Technology,Copiers,1384,1384,1295
AZ-2011-597829,140,6,5,Office Supplies,Storage,134,134,30
AZ-2011-5981422,148,59,3,Office Supplies,Binders,89,89,177
AZ-2011-6011646,64,24,2,Office Supplies,Art,40,40,48
AZ-2011-6019271,188,23,3,Furniture,Chairs,165,165,69
AZ-2011-6019271,33,14,4,Office Supplies,Fasteners,19,19,56
AZ-2011-6019271,643,53,6,Technology,Phones,590,590,318
AZ-2011-6026153,26,8,2,Office Supplies,Binders,18,18,16
AZ-2011-6048331,26,1,1,Office Supplies,Art,25,25,1
AZ-2011-6048331,9,2,1,Office Supplies,Storage,7,7,2
AZ-2011-6053355,249,30,5,Office Supplies,Paper,219,219,150
AZ-2011-6106265,178,82,8,Office Supplies,Envelopes,96,96,656
AZ-2011-6122805,123,10,4,Office Supplies,Storage,113,113,40
AZ-2011-6123217,547,159,3,Furniture,Chairs,388,388,477
AZ-2011-6133674,93,44,2,Office Supplies,Art,49,49,88
AZ-2011-6142647,28,4,1,Office Supplies,Art,24,24,4
AZ-2011-6172786,1429,577,6,Technology,Copiers,329,852,3462
AZ-2011-617423,297,98,7,Office Supplies,Art,69,199,686
AZ-2011-6186921,10,2,2,Office Supplies,Binders,8,8,4
AZ-2011-6212291,139,0,4,Office Supplies,Supplies,139,139,0
AZ-2011-6222257,43,20,3,Office Supplies,Art,23,23,60
AZ-2011-6222257,193,62,6,Office Supplies,Supplies,131,131,372
AZ-2011-6223481,199,56,4,Office Supplies,Binders,143,143,224
AZ-2011-6223481,68,29,2,Office Supplies,Paper,39,39,58
AZ-2011-6256805,51,23,4,Office Supplies,Binders,28,28,92
AZ-2011-6256805,69,27,2,Office Supplies,Supplies,42,42,54
AZ-2011-6268545,561,34,2,Office Supplies,Appliances,527,527,68
AZ-2011-6268545,249,40,2,Technology,Copiers,209,209,80
AZ-2011-6274862,13,1,2,Office Supplies,Binders,12,12,2
AZ-2011-6288321,11,5,1,Office Supplies,Fasteners,6,6,5
AZ-2011-6288321,586,88,8,Technology,Phones,498,498,704
AZ-2011-6296214,267,29,2,Furniture,Chairs,238,238,58
AZ-2011-6296214,275,8,4,Office Supplies,Appliances,267,267,32
AZ-2011-6296214,9,3,2,Office Supplies,Labels,6,6,6
AZ-2011-6296469,53,-18,4,Office Supplies,Paper,71,71,-72
AZ-2011-6314494,40,16,3,Office Supplies,Binders,24,24,48
AZ-2011-6314494,90,27,2,Office Supplies,Paper,63,63,54
AZ-2011-635398,50,13,2,Office Supplies,Supplies,37,37,26
AZ-2011-6377121,168,7,6,Office Supplies,Storage,161,161,42
AZ-2011-6402982,1295,609,5,Technology,Accessories,686,686,3045
AZ-2011-643323,18,3,2,Office Supplies,Labels,15,15,6
AZ-2011-643323,645,76,5,Technology,Phones,569,569,380
AZ-2011-6439906,268,-342,2,Furniture,Tables,610,610,-684
AZ-2011-6439906,40,6,5,Office Supplies,Labels,34,34,30
AZ-2011-6447932,247,35,2,Furniture,Bookcases,212,212,70
AZ-2011-6532640,109,52,2,Office Supplies,Art,57,57,104
AZ-2011-6532640,1025,400,4,Technology,Accessories,625,625,1600
AZ-2011-6535299,37,17,3,Office Supplies,Binders,20,20,51
AZ-2011-6545414,42,16,5,Office Supplies,Labels,26,26,80
AZ-2011-6545414,349,175,7,Office Supplies,Supplies,174,174,1225
AZ-2011-6557147,360,32,3,Office Supplies,Storage,328,328,96
AZ-2011-6561347,117,6,4,Office Supplies,Art,111,111,24
AZ-2011-658574,55,8,2,Office Supplies,Art,47,47,16
AZ-2011-658574,42,14,6,Office Supplies,Labels,28,28,84
AZ-2011-6587022,479,202,4,Furniture,Chairs,277,277,808
AZ-2011-6587022,57,17,2,Office Supplies,Binders,40,40,34
AZ-2011-65889,646,50,9,Furniture,Chairs,596,596,450
AZ-2011-65889,88,32,2,Office Supplies,Supplies,56,56,64
AZ-2011-65889,388,27,6,Technology,Phones,361,361,162
AZ-2011-6604383,613,37,3,Office Supplies,Storage,576,576,111
AZ-2011-6634822,514,92,3,Furniture,Bookcases,422,422,276
AZ-2011-6634822,57,25,1,Furniture,Furnishings,32,32,25
AZ-2011-6634822,68,7,2,Office Supplies,Paper,61,61,14
AZ-2011-6634822,107,8,7,Office Supplies,Storage,99,99,56
AZ-2011-6646927,278,47,6,Office Supplies,Art,181,231,282
AZ-2011-6646927,37,6,4,Office Supplies,Storage,31,31,24
AZ-2011-666847,239,96,8,Office Supplies,Binders,143,143,768
AZ-2011-666847,187,59,3,Technology,Phones,128,128,177
AZ-2011-6674300,140,21,3,Office Supplies,Art,119,119,63
AZ-2011-6683192,36,10,3,Office Supplies,Envelopes,26,26,30
AZ-2011-6683192,36,8,3,Office Supplies,Labels,28,28,24
AZ-2011-6683192,354,174,3,Technology,Machines,180,180,522
AZ-2011-6684426,28,4,1,Office Supplies,Art,24,24,4
AZ-2011-6705309,1236,420,3,Furniture,Bookcases,816,816,1260
AZ-2011-6705309,234,110,5,Office Supplies,Art,124,124,550
AZ-2011-6705309,335,18,12,Office Supplies,Binders,119,317,216
AZ-2011-6712797,22,7,3,Office Supplies,Binders,15,15,21
AZ-2011-6760420,1542,200,9,Furniture,Bookcases,1342,1342,1800
AZ-2011-6760420,1395,572,3,Furniture,Chairs,823,823,1716
AZ-2011-6760420,184,57,3,Office Supplies,Storage,127,127,171
AZ-2011-6760420,179,23,12,Office Supplies,Supplies,156,156,276
AZ-2011-6765105,301,73,2,Technology,Phones,228,228,146
AZ-2011-6783792,83,31,6,Office Supplies,Binders,52,52,186
AZ-2011-6807336,1113,260,3,Furniture,Bookcases,853,853,780
AZ-2011-6807336,86,18,5,Office Supplies,Art,51,68,90
AZ-2011-6819869,90,36,3,Office Supplies,Binders,54,54,108
AZ-2011-6835828,149,15,3,Office Supplies,Storage,134,134,45
AZ-2011-6843566,35,11,4,Office Supplies,Labels,24,24,44
AZ-2011-6843566,65,3,1,Technology,Phones,62,62,3
AZ-2011-6919505,64,3,4,Office Supplies,Art,61,61,12
AZ-2011-6969006,58,29,3,Office Supplies,Fasteners,29,29,87
AZ-2011-7005483,139,36,3,Office Supplies,Art,103,103,108
AZ-2011-7007630,243,44,11,Office Supplies,Art,199,199,484
AZ-2011-7014445,60,2,1,Office Supplies,Appliances,58,58,2
AZ-2011-7014445,44,8,2,Office Supplies,Art,36,36,16
AZ-2011-7024596,26,0,2,Office Supplies,Art,26,26,0
AZ-2011-7041508,60,24,2,Office Supplies,Binders,36,36,48
AZ-2011-7043718,729,241,2,Furniture,Bookcases,488,488,482
AZ-2011-7043718,266,23,4,Furniture,Chairs,243,243,92
AZ-2011-7043718,173,14,5,Office Supplies,Art,56,159,70
AZ-2011-7053593,1384,14,3,Furniture,Chairs,1370,1370,42
AZ-2011-7053593,103,20,2,Office Supplies,Art,83,83,40
AZ-2011-7072417,53,2,4,Office Supplies,Binders,51,51,8
AZ-2011-7072417,81,19,3,Office Supplies,Supplies,62,62,57
AZ-2011-7077665,874,341,7,Furniture,Bookcases,533,533,2387
AZ-2011-7077665,11,2,1,Office Supplies,Binders,9,9,2
AZ-2011-7080428,113,56,1,Technology,Accessories,57,57,56
AZ-2011-7089649,86,33,5,Office Supplies,Fasteners,53,53,165
AZ-2011-7123116,122,52,4,Technology,Accessories,70,70,208
AZ-2011-7123116,3033,409,8,Technology,Copiers,902,2624,3272
AZ-2011-7159051,129,20,9,Office Supplies,Art,70,109,180
AZ-2011-7159051,44,1,1,Office Supplies,Storage,43,43,1
AZ-2011-7159551,107,0,2,Office Supplies,Art,107,107,0
AZ-2011-7159551,51,9,3,Office Supplies,Paper,42,42,27
AZ-2011-7162549,808,197,6,Furniture,Chairs,611,611,1182
AZ-2011-7162549,299,109,10,Office Supplies,Paper,172,190,1090
AZ-2011-7162549,976,293,4,Technology,Accessories,683,683,1172
AZ-2011-7176168,18,8,2,Office Supplies,Binders,10,10,16
AZ-2011-7181024,76,9,4,Furniture,Furnishings,67,67,36
AZ-2011-7200468,599,53,5,Office Supplies,Storage,546,546,265
AZ-2011-7213764,120,46,9,Office Supplies,Binders,74,74,414
AZ-2011-7213764,113,19,7,Office Supplies,Fasteners,94,94,133
AZ-2011-7213826,205,39,4,Office Supplies,Art,166,166,156
AZ-2011-7213826,12,4,2,Office Supplies,Binders,8,8,8
AZ-2011-7213826,316,30,4,Office Supplies,Storage,42,286,120
AZ-2011-7213826,4453,1425,7,Technology,Phones,3028,3028,9975
AZ-2011-7225915,143,41,1,Furniture,Bookcases,102,102,41
AZ-2011-7255147,780,117,2,Furniture,Bookcases,663,663,234
AZ-2011-7255147,19,8,1,Office Supplies,Art,11,11,8
AZ-2011-7326281,51,-1,3,Office Supplies,Fasteners,52,52,-3
AZ-2011-734782,1076,24,6,Furniture,Bookcases,1052,1052,144
AZ-2011-734782,40,8,2,Furniture,Furnishings,32,32,16
AZ-2011-734782,104,28,6,Office Supplies,Envelopes,76,76,168
AZ-2011-7404693,71,32,3,Office Supplies,Storage,39,39,96
AZ-2011-7404693,189,45,7,Office Supplies,Supplies,144,144,315
AZ-2011-7412293,63,8,2,Furniture,Furnishings,55,55,16
AZ-2011-7412293,415,66,5,Technology,Accessories,349,349,330
AZ-2011-7419210,108,33,8,Office Supplies,Fasteners,75,75,264
AZ-2011-7479897,181,36,9,Furniture,Furnishings,145,145,324
AZ-2011-7479897,537,145,2,Technology,Machines,392,392,290
AZ-2011-7499604,132,9,3,Furniture,Furnishings,123,123,27
AZ-2011-7499604,50,3,3,Office Supplies,Storage,47,47,9
AZ-2011-7534020,117,36,5,Furniture,Furnishings,81,81,180
AZ-2011-7534020,153,70,3,Office Supplies,Binders,83,83,210
AZ-2011-7543304,754,142,6,Furniture,Bookcases,136,612,852
AZ-2011-7543304,469,146,7,Furniture,Chairs,323,323,1022
AZ-2011-7543304,229,51,3,Office Supplies,Appliances,178,178,153
AZ-2011-7543304,57,25,3,Office Supplies,Art,19,32,75
AZ-2011-7543304,359,123,7,Office Supplies,Storage,236,236,861
AZ-2011-7543304,354,141,4,Technology,Phones,213,213,564
AZ-2011-7586957,191,25,7,Office Supplies,Binders,166,166,175
AZ-2011-7586957,81,10,2,Technology,Accessories,71,71,20
AZ-2011-7589945,57,16,1,Furniture,Furnishings,41,41,16
AZ-2011-7643452,35,11,3,Office Supplies,Supplies,24,24,33
AZ-2011-7647834,166,76,10,Office Supplies,Paper,90,90,760
AZ-2011-7652463,1064,239,6,Furniture,Bookcases,261,825,1434
AZ-2011-7652463,37,3,2,Office Supplies,Envelopes,34,34,6
AZ-2011-7652463,323,122,5,Technology,Phones,201,201,610
AZ-2011-7655744,26,10,4,Office Supplies,Binders,16,16,40
AZ-2011-7659767,507,175,4,Furniture,Chairs,332,332,700
AZ-2011-7671743,15,7,2,Office Supplies,Envelopes,8,8,14
AZ-2011-7675351,249,3,1,Office Supplies,Appliances,246,246,3
AZ-2011-7675351,21,7,2,Office Supplies,Labels,14,14,14
AZ-2011-7675351,170,25,5,Office Supplies,Paper,145,145,125
AZ-2011-7675351,55,2,2,Office Supplies,Supplies,53,53,4
AZ-2011-7675351,527,11,2,Technology,Copiers,516,516,22
AZ-2011-7677596,117,15,7,Office Supplies,Fasteners,102,102,105
AZ-2011-7682838,167,7,4,Office Supplies,Envelopes,160,160,28
AZ-2011-7682838,273,57,2,Office Supplies,Storage,216,216,114
AZ-2011-7687877,106,28,5,Office Supplies,Art,78,78,140
AZ-2011-7694862,21,8,3,Office Supplies,Labels,13,13,24
AZ-2011-7695869,99,10,2,Office Supplies,Storage,89,89,20
AZ-2011-7732593,1389,154,5,Office Supplies,Appliances,1235,1235,770
AZ-2011-7732849,104,2,3,Office Supplies,Envelopes,102,102,6
AZ-2011-7732849,238,20,2,Office Supplies,Storage,218,218,40
AZ-2011-7779959,1983,617,5,Furniture,Bookcases,1366,1366,3085
AZ-2011-7779959,24,4,4,Office Supplies,Binders,20,20,16
AZ-2011-7783675,155,57,3,Office Supplies,Art,98,98,171
AZ-2011-7783675,137,19,10,Office Supplies,Binders,118,118,190
AZ-2011-7783675,32,5,3,Office Supplies,Labels,27,27,15
AZ-2011-7804688,66,14,3,Office Supplies,Supplies,52,52,42
AZ-2011-7833524,387,46,3,Furniture,Chairs,341,341,138
AZ-2011-7845997,42,11,3,Office Supplies,Art,31,31,33
AZ-2011-7847155,92,8,3,Furniture,Furnishings,84,84,24
AZ-2011-7847155,200,12,8,Office Supplies,Art,188,188,96
AZ-2011-7849219,301,112,7,Office Supplies,Supplies,126,189,784
AZ-2011-7868957,88,16,4,Office Supplies,Art,72,72,64
AZ-2011-7873401,640,160,2,Technology,Copiers,480,480,320
AZ-2011-7903656,1314,342,3,Furniture,Bookcases,972,972,1026
AZ-2011-7903656,705,289,5,Furniture,Chairs,416,416,1445
AZ-2011-7903656,232,45,7,Office Supplies,Art,160,187,315
AZ-2011-7921819,393,-157,5,Furniture,Bookcases,550,550,-785
AZ-2011-7921819,311,-278,11,Furniture,Chairs,238,589,-3058
AZ-2011-7921819,31,-1,9,Office Supplies,Binders,32,32,-9
AZ-2011-7934727,200,22,4,Furniture,Chairs,178,178,88
AZ-2011-7934727,14,5,1,Office Supplies,Art,9,9,5
AZ-2011-7934727,71,10,1,Technology,Accessories,61,61,10
AZ-2011-7934727,649,26,5,Technology,Phones,623,623,130
AZ-2011-7944653,41,3,3,Office Supplies,Supplies,38,38,9
AZ-2011-7944653,191,27,1,Technology,Copiers,164,164,27
AZ-2011-7962115,43,20,5,Office Supplies,Labels,23,23,100
AZ-2011-7962115,98,38,2,Technology,Machines,60,60,76
AZ-2011-7976569,1413,503,5,Technology,Machines,910,910,2515
AZ-2011-7981755,94,24,5,Office Supplies,Art,70,70,120
AZ-2011-800016,103,30,2,Furniture,Furnishings,73,73,60
AZ-2011-800016,1057,412,2,Office Supplies,Appliances,645,645,824
AZ-2011-8007862,26,7,2,Office Supplies,Labels,19,19,14
AZ-2011-8032051,66,12,3,Office Supplies,Art,54,54,36
AZ-2011-8034411,825,338,2,Furniture,Bookcases,487,487,676
AZ-2011-8034411,54,12,1,Office Supplies,Art,42,42,12
AZ-2011-8034411,889,59,7,Office Supplies,Storage,830,830,413
AZ-2011-804486,66,12,3,Office Supplies,Art,54,54,36
AZ-2011-804486,26,12,3,Office Supplies,Labels,14,14,36
AZ-2011-804486,186,89,4,Office Supplies,Paper,97,97,356
AZ-2011-804486,693,229,5,Technology,Phones,464,464,1145
AZ-2011-8060550,158,69,3,Office Supplies,Art,89,89,207
AZ-2011-8060550,296,32,6,Office Supplies,Binders,264,264,192
AZ-2011-8060550,123,50,3,Technology,Accessories,73,73,150
AZ-2011-8060803,2624,446,6,Furniture,Bookcases,2178,2178,2676
AZ-2011-8060803,34,8,3,Office Supplies,Art,26,26,24
AZ-2011-8060803,423,30,2,Office Supplies,Storage,393,393,60
AZ-2011-8069544,70,11,8,Office Supplies,Labels,59,59,88
AZ-2011-8072611,392,31,3,Furniture,Chairs,361,361,93
AZ-2011-8072611,60,14,2,Office Supplies,Art,46,46,28
AZ-2011-8072611,235,7,5,Office Supplies,Paper,228,228,35
AZ-2011-8074602,151,-5,2,Technology,Accessories,156,156,-10
AZ-2011-8078797,326,107,3,Furniture,Furnishings,219,219,321
AZ-2011-8091357,103,30,2,Furniture,Furnishings,73,73,60
AZ-2011-8091357,127,28,10,Office Supplies,Binders,29,99,280
AZ-2011-8091357,477,40,3,Technology,Machines,437,437,120
AZ-2011-8121091,14,5,1,Office Supplies,Labels,9,9,5
AZ-2011-8122214,35,14,3,Office Supplies,Fasteners,21,21,42
AZ-2011-8123773,82,20,8,Office Supplies,Supplies,62,62,160
AZ-2011-8128467,104,19,2,Office Supplies,Binders,85,85,38
AZ-2011-8128467,736,90,6,Office Supplies,Storage,646,646,540
AZ-2011-8128467,1112,379,2,Technology,Phones,733,733,758
AZ-2011-8128618,18,6,3,Office Supplies,Binders,12,12,18
AZ-2011-8129966,38,14,2,Office Supplies,Art,24,24,28
AZ-2011-8129966,192,90,5,Office Supplies,Supplies,102,102,450
AZ-2011-8155253,67,29,3,Furniture,Furnishings,38,38,87
AZ-2011-8155253,68,22,7,Office Supplies,Labels,46,46,154
AZ-2011-8155253,96,20,7,Office Supplies,Paper,76,76,140
AZ-2011-8155253,868,29,7,Office Supplies,Storage,839,839,203
AZ-2011-8164175,280,45,6,Technology,Accessories,235,235,270
AZ-2011-816625,769,299,6,Furniture,Bookcases,470,470,1794
AZ-2011-816625,85,14,2,Furniture,Furnishings,71,71,28
AZ-2011-816625,368,70,7,Office Supplies,Art,298,298,490
AZ-2011-816625,34,8,3,Office Supplies,Labels,26,26,24
AZ-2011-819110,50,24,4,Office Supplies,Envelopes,26,26,96
AZ-2011-819110,206,27,2,Technology,Machines,179,179,54
AZ-2011-8207490,100,33,2,Office Supplies,Art,67,67,66
AZ-2011-821395,99,33,2,Office Supplies,Art,66,66,66
AZ-2011-821395,379,27,2,Technology,Copiers,352,352,54
AZ-2011-8223268,322,80,6,Office Supplies,Art,242,242,480
AZ-2011-8227978,211,19,3,Technology,Accessories,192,192,57
AZ-2011-8232296,34,12,3,Office Supplies,Binders,22,22,36
AZ-2011-823697,3070,1364,6,Office Supplies,Appliances,1706,1706,8184
AZ-2011-823697,230,20,2,Office Supplies,Storage,210,210,40
AZ-2011-8245903,428,138,1,Furniture,Chairs,290,290,138
AZ-2011-8245903,63,14,5,Office Supplies,Binders,36,49,70
AZ-2011-8245903,112,18,6,Office Supplies,Fasteners,94,94,108
AZ-2011-8245903,142,68,5,Office Supplies,Paper,74,74,340
AZ-2011-8245903,256,-6,6,Office Supplies,Storage,262,262,-36
AZ-2011-8245903,295,83,2,Technology,Phones,212,212,166
AZ-2011-8252363,21,7,3,Office Supplies,Labels,14,14,21
AZ-2011-8252363,81,12,5,Office Supplies,Storage,69,69,60
AZ-2011-8257474,16,2,1,Office Supplies,Fasteners,14,14,2
AZ-2011-8275005,669,290,5,Technology,Copiers,379,379,1450
AZ-2011-8279503,2076,104,5,Furniture,Bookcases,1972,1972,520
AZ-2011-8279503,309,77,6,Office Supplies,Binders,232,232,462
AZ-2011-8279503,525,58,2,Technology,Copiers,467,467,116
AZ-2011-8295770,229,28,9,Office Supplies,Binders,201,201,252
AZ-2011-8308381,605,103,14,Office Supplies,Binders,426,502,1442
AZ-2011-8308381,230,20,2,Office Supplies,Storage,210,210,40
AZ-2011-8308381,246,3,2,Technology,Phones,243,243,6
AZ-2011-831255,152,14,5,Office Supplies,Binders,138,138,70
AZ-2011-8335226,68,21,3,Furniture,Furnishings,47,47,63
AZ-2011-8335226,95,36,2,Office Supplies,Art,59,59,72
AZ-2011-8335226,488,67,3,Office Supplies,Storage,421,421,201
AZ-2011-8335226,104,15,2,Technology,Accessories,89,89,30
AZ-2011-8335226,228,-20,5,Technology,Machines,248,248,-100
AZ-2011-8338326,143,32,1,Furniture,Bookcases,111,111,32
AZ-2011-8338326,190,68,4,Office Supplies,Envelopes,122,122,272
AZ-2011-8338326,597,185,5,Technology,Machines,412,412,925
AZ-2011-8338326,584,263,4,Technology,Phones,321,321,1052
AZ-2011-8345224,244,68,9,Office Supplies,Supplies,176,176,612
AZ-2011-8361446,61,21,2,Office Supplies,Art,40,40,42
AZ-2011-8369879,729,-57,5,Furniture,Chairs,786,786,-285
AZ-2011-8369879,51,-1,5,Office Supplies,Storage,52,52,-5
AZ-2011-8369879,285,14,2,Technology,Copiers,271,271,28
AZ-2011-8369879,390,16,3,Technology,Phones,374,374,48
AZ-2011-8378099,149,15,3,Office Supplies,Envelopes,134,134,45
AZ-2011-838467,13,-8,1,Office Supplies,Paper,21,21,-8
AZ-2011-838467,86,0,1,Technology,Copiers,86,86,0
AZ-2011-838467,584,-59,8,Technology,Phones,643,643,-472
AZ-2011-8385833,1253,237,5,Office Supplies,Appliances,1016,1016,1185
AZ-2011-8385833,42,10,3,Office Supplies,Fasteners,32,32,30
AZ-2011-8385833,186,62,15,Office Supplies,Labels,66,124,930
AZ-2011-8385833,30,-1,2,Office Supplies,Storage,31,31,-2
AZ-2011-839331,518,160,3,Furniture,Bookcases,358,358,480
AZ-2011-839331,71,1,5,Office Supplies,Art,70,70,5
AZ-2011-839331,88,9,5,Office Supplies,Paper,79,79,45
AZ-2011-839331,73,30,1,Technology,Machines,43,43,30
AZ-2011-8408139,51,20,3,Office Supplies,Storage,31,31,60
AZ-2011-8421926,171,34,3,Furniture,Chairs,137,137,102
AZ-2011-8421926,55,11,9,Office Supplies,Labels,44,44,99
AZ-2011-8427293,1207,109,4,Office Supplies,Appliances,1098,1098,436
AZ-2011-8465032,317,28,12,Office Supplies,Art,289,289,336
AZ-2011-8510218,42,14,4,Office Supplies,Binders,28,28,56
AZ-2011-8519360,101,46,4,Furniture,Furnishings,55,55,184
AZ-2011-8557456,14,2,1,Office Supplies,Art,12,12,2
AZ-2011-8557456,714,278,4,Office Supplies,Storage,436,436,1112
AZ-2011-8642559,165,58,3,Office Supplies,Art,107,107,174
AZ-2011-8642559,147,53,3,Office Supplies,Binders,94,94,159
AZ-2011-8648970,45,22,2,Office Supplies,Supplies,23,23,44
AZ-2011-8709949,158,30,3,Office Supplies,Art,128,128,90
AZ-2011-8709949,84,29,2,Office Supplies,Supplies,55,55,58
AZ-2011-8709949,538,-19,2,Technology,Copiers,557,557,-38
AZ-2011-8727445,60,22,4,Office Supplies,Art,38,38,88
AZ-2011-8727445,116,24,9,Office Supplies,Labels,92,92,216
AZ-2011-8727445,52,23,1,Office Supplies,Storage,29,29,23
AZ-2011-8727445,250,105,3,Technology,Machines,145,145,315
AZ-2011-8734686,206,25,5,Office Supplies,Supplies,181,181,125
AZ-2011-8737,99,24,2,Office Supplies,Art,75,75,48
AZ-2011-8737,83,2,4,Office Supplies,Storage,81,81,8
AZ-2011-8738856,149,36,3,Office Supplies,Art,113,113,108
AZ-2011-8742152,689,84,11,Furniture,Chairs,605,605,924
AZ-2011-8742152,62,6,5,Office Supplies,Binders,56,56,30
AZ-2011-8742773,43,1,3,Office Supplies,Art,42,42,3
AZ-2011-8743509,170,27,4,Furniture,Furnishings,143,143,108
AZ-2011-8743509,38,3,2,Office Supplies,Supplies,35,35,6
AZ-2011-8743509,639,45,1,Technology,Phones,594,594,45
AZ-2011-8748429,50,15,5,Office Supplies,Labels,7,35,75
AZ-2011-8748429,164,16,3,Office Supplies,Storage,148,148,48
AZ-2011-8748429,616,37,5,Technology,Phones,579,579,185
AZ-2011-8761469,439,79,8,Office Supplies,Art,360,360,632
AZ-2011-8761469,41,7,3,Office Supplies,Supplies,34,34,21
AZ-2011-8788804,38,8,2,Office Supplies,Art,30,30,16
AZ-2011-8788804,215,60,11,Office Supplies,Paper,155,155,660
AZ-2011-8806181,169,48,8,Office Supplies,Binders,21,121,384
AZ-2011-8820375,17,5,1,Office Supplies,Art,12,12,5
AZ-2011-8820375,184,82,3,Technology,Phones,102,102,246
AZ-2011-882043,23,6,2,Office Supplies,Labels,17,17,12
AZ-2011-8824972,201,26,12,Office Supplies,Fasteners,175,175,312
AZ-2011-8824972,73,0,3,Office Supplies,Storage,73,73,0
AZ-2011-8844789,2521,803,11,Furniture,Chairs,1161,1718,8833
AZ-2011-8844789,5,2,1,Office Supplies,Binders,3,3,2
AZ-2011-8844789,31,6,3,Office Supplies,Labels,25,25,18
AZ-2011-8844789,218,7,5,Office Supplies,Storage,211,211,35
AZ-2011-8847796,173,55,7,Office Supplies,Art,118,118,385
AZ-2011-8847796,46,21,6,Office Supplies,Binders,25,25,126
AZ-2011-8864835,22,0,1,Office Supplies,Art,22,22,0
AZ-2011-8878816,677,61,4,Furniture,Bookcases,616,616,244
AZ-2011-8878816,1264,38,16,Office Supplies,Storage,732,1226,608
AZ-2011-8878816,144,13,3,Office Supplies,Supplies,131,131,39
AZ-2011-8878816,589,277,4,Technology,Copiers,312,312,1108
AZ-2011-8893613,593,251,7,Furniture,Chairs,342,342,1757
AZ-2011-8898585,25,6,3,Office Supplies,Storage,19,19,18
AZ-2011-8906544,50,15,4,Office Supplies,Fasteners,35,35,60
AZ-2011-8906544,1127,132,9,Office Supplies,Storage,629,995,1188
AZ-2011-8945919,175,54,4,Furniture,Furnishings,121,121,216
AZ-2011-8945919,994,199,7,Technology,Phones,795,795,1393
AZ-2011-8949674,705,102,4,Furniture,Bookcases,603,603,408
AZ-2011-8949674,380,131,3,Furniture,Chairs,249,249,393
AZ-2011-8967076,158,30,3,Office Supplies,Art,128,128,90
AZ-2011-8967076,35,3,2,Office Supplies,Paper,32,32,6
AZ-2011-8967076,1066,-12,6,Office Supplies,Storage,1078,1078,-72
AZ-2011-8967076,28,2,2,Office Supplies,Supplies,26,26,4
AZ-2011-8968615,338,139,2,Furniture,Bookcases,199,199,278
AZ-2011-8973571,2905,186,16,Office Supplies,Storage,31,2719,2976
AZ-2011-8973571,164,6,6,Office Supplies,Supplies,158,158,36
AZ-2011-897579,514,108,4,Furniture,Bookcases,406,406,432
AZ-2011-897579,320,82,2,Furniture,Chairs,238,238,164
AZ-2011-897579,33,10,3,Office Supplies,Binders,23,23,30
AZ-2011-897579,60,-3,4,Office Supplies,Storage,63,63,-12
AZ-2011-897579,154,46,5,Technology,Accessories,108,108,230
AZ-2011-9008538,28,9,1,Office Supplies,Binders,19,19,9
AZ-2011-9028844,1200,373,8,Furniture,Chairs,827,827,2984
AZ-2011-9028844,83,18,3,Office Supplies,Paper,65,65,54
AZ-2011-9050313,854,290,7,Furniture,Bookcases,564,564,2030
AZ-2011-9083887,35,8,3,Office Supplies,Binders,27,27,24
AZ-2011-9083887,62,14,2,Office Supplies,Paper,48,48,28
AZ-2011-9083887,78,-47,2,Technology,Phones,125,125,-94
AZ-2011-9107304,368,15,3,Furniture,Bookcases,353,353,45
AZ-2011-9107304,93,24,2,Office Supplies,Art,69,69,48
AZ-2011-9107304,85,18,3,Office Supplies,Binders,67,67,54
AZ-2011-9107304,48,5,3,Office Supplies,Fasteners,43,43,15
AZ-2011-9107304,60,-3,4,Office Supplies,Storage,63,63,-12
AZ-2011-9119536,112,55,4,Office Supplies,Paper,57,57,220
AZ-2011-9119536,239,-48,2,Office Supplies,Storage,287,287,-96
AZ-2011-9121322,26,10,2,Office Supplies,Binders,16,16,20
AZ-2011-9121322,185,78,4,Office Supplies,Envelopes,107,107,312
AZ-2011-9121322,130,-20,4,Technology,Machines,150,150,-80
AZ-2011-9135395,320,160,6,Office Supplies,Storage,160,160,960
AZ-2011-9137114,410,155,3,Furniture,Bookcases,255,255,465
AZ-2011-9146320,28,10,2,Office Supplies,Binders,18,18,20
AZ-2011-9147201,52,23,5,Office Supplies,Art,29,29,115
AZ-2011-9147715,74,-18,2,Furniture,Chairs,92,92,-36
AZ-2011-9153342,322,80,6,Office Supplies,Art,242,242,480
AZ-2011-9153342,112,24,8,Office Supplies,Fasteners,88,88,192
AZ-2011-9153342,31,1,2,Office Supplies,Paper,30,30,2
AZ-2011-9153342,672,87,4,Technology,Phones,585,585,348
AZ-2011-9155070,24,8,4,Office Supplies,Binders,16,16,32
AZ-2011-9155070,129,-2,3,Technology,Machines,131,131,-6
AZ-2011-9162974,293,15,6,Furniture,Furnishings,278,278,90
AZ-2011-9162974,248,82,5,Office Supplies,Art,166,166,410
AZ-2011-9162974,117,33,6,Office Supplies,Paper,84,84,198
AZ-2011-9164512,53,17,3,Furniture,Furnishings,36,36,51
AZ-2011-9164512,174,-38,5,Office Supplies,Appliances,212,212,-190
AZ-2011-9164512,169,-125,3,Technology,Accessories,294,294,-375
AZ-2011-9167855,76,19,3,Office Supplies,Binders,57,57,57
AZ-2011-9167855,149,36,2,Technology,Phones,113,113,72
AZ-2011-9172584,51,12,3,Furniture,Furnishings,39,39,36
AZ-2011-9194903,125,5,3,Office Supplies,Envelopes,120,120,15
AZ-2011-9195433,351,24,8,Furniture,Furnishings,327,327,192
AZ-2011-921935,1306,261,9,Furniture,Chairs,1045,1045,2349
AZ-2011-9278870,17,7,1,Office Supplies,Art,10,10,7
AZ-2011-9278870,136,41,3,Office Supplies,Paper,95,95,123
AZ-2011-9278870,28,5,3,Office Supplies,Storage,23,23,15
AZ-2011-9316144,176,19,3,Technology,Accessories,157,157,57
AZ-2011-9350558,702,221,6,Furniture,Bookcases,273,481,1326
AZ-2011-9357982,112,12,4,Office Supplies,Art,100,100,48
AZ-2011-9357982,32,9,2,Office Supplies,Fasteners,23,23,18
AZ-2011-9357982,539,100,7,Office Supplies,Storage,20,439,700
AZ-2011-9409671,51,14,2,Office Supplies,Art,37,37,28
AZ-2011-9409671,32,16,3,Office Supplies,Labels,16,16,48
AZ-2011-9421435,31,11,3,Office Supplies,Labels,20,20,33
AZ-2011-9431896,4449,1518,8,Technology,Phones,2931,2931,12144
AZ-2011-9451747,54,4,3,Office Supplies,Art,50,50,12
AZ-2011-9505872,99,45,5,Office Supplies,Fasteners,54,54,225
AZ-2011-9510405,10,4,2,Office Supplies,Binders,6,6,8
AZ-2011-9520720,108,41,2,Office Supplies,Storage,67,67,82
AZ-2011-9528187,119,16,11,Office Supplies,Labels,103,103,176
AZ-2011-9528187,73,23,1,Technology,Phones,50,50,23
AZ-2011-9598217,31,1,5,Office Supplies,Binders,30,30,5
AZ-2011-9598217,65,32,6,Office Supplies,Labels,33,33,192
AZ-2011-9598217,48,7,2,Office Supplies,Storage,41,41,14
AZ-2011-9598217,81,24,5,Office Supplies,Supplies,57,57,120
AZ-2011-9620626,100,28,2,Office Supplies,Binders,72,72,56
AZ-2011-9620626,44,14,5,Office Supplies,Labels,30,30,70
AZ-2011-9620626,220,56,5,Office Supplies,Storage,164,164,280
AZ-2011-9632713,112,5,4,Office Supplies,Storage,107,107,20
AZ-2011-96343,97,-86,4,Office Supplies,Storage,27,183,-344
AZ-2011-96343,739,-177,6,Technology,Accessories,916,916,-1062
AZ-2011-9652940,246,61,2,Furniture,Bookcases,185,185,122
AZ-2011-9670304,676,81,14,Office Supplies,Binders,595,595,1134
AZ-2011-9670304,371,-41,3,Office Supplies,Storage,412,412,-123
AZ-2011-9670304,31,13,1,Technology,Accessories,18,18,13
AZ-2011-9670304,379,152,3,Technology,Copiers,227,227,456
AZ-2011-9670304,219,82,5,Technology,Machines,137,137,410
AZ-2011-9700826,220,49,1,Technology,Accessories,171,171,49
AZ-2011-9703855,278,62,5,Office Supplies,Storage,216,216,310
AZ-2011-9703855,411,-37,9,Technology,Machines,448,448,-333
AZ-2011-9710351,52,16,5,Office Supplies,Labels,36,36,80
AZ-2011-9711046,42,9,3,Office Supplies,Fasteners,33,33,27
AZ-2011-9715464,97,29,2,Office Supplies,Binders,68,68,58
AZ-2011-9722198,10,4,2,Office Supplies,Binders,6,6,8
AZ-2011-9732880,305,105,2,Furniture,Bookcases,200,200,210
AZ-2011-9732880,555,0,2,Office Supplies,Appliances,555,555,0
AZ-2011-9732880,52,7,3,Office Supplies,Art,45,45,21
AZ-2011-9732880,34,1,3,Office Supplies,Binders,33,33,3
AZ-2011-9732880,34,8,3,Office Supplies,Fasteners,26,26,24
AZ-2011-9732880,67,25,3,Office Supplies,Paper,42,42,75
AZ-2011-9747557,17,8,2,Office Supplies,Envelopes,9,9,16
AZ-2011-9747665,3178,-177,9,Furniture,Bookcases,3355,3355,-1593
AZ-2011-9747665,669,-45,14,Furniture,Chairs,714,714,-630
AZ-2011-9747665,23,4,1,Office Supplies,Envelopes,19,19,4
AZ-2011-9777525,32,7,3,Office Supplies,Binders,25,25,21
AZ-2011-9777525,405,8,4,Technology,Accessories,397,397,32
AZ-2011-9806635,29,10,4,Office Supplies,Binders,19,19,40
AZ-2011-9806635,524,5,2,Technology,Copiers,519,519,10
AZ-2011-981373,127,44,1,Furniture,Chairs,83,83,44
AZ-2011-981373,92,15,4,Office Supplies,Envelopes,77,77,60
AZ-2011-9846690,131,38,2,Technology,Phones,93,93,76
AZ-2011-9876342,238,26,7,Office Supplies,Paper,212,212,182
AZ-2011-9882660,42,12,4,Office Supplies,Fasteners,30,30,48
AZ-2011-9883921,86,4,6,Office Supplies,Binders,82,82,24
AZ-2011-9883921,78,14,8,Office Supplies,Storage,64,64,112
AZ-2011-9917214,91,39,11,Office Supplies,Binders,9,52,429
AZ-2011-9927716,290,70,5,Furniture,Chairs,220,220,350
AZ-2011-9958697,112,4,5,Furniture,Furnishings,108,108,20
AZ-2011-9958697,26,10,3,Office Supplies,Labels,16,16,30
AZ-2011-9983326,29,1,2,Office Supplies,Binders,28,28,2
AZ-2011-9983326,294,-48,4,Technology,Phones,47,342,-192
AZ-2011-9992253,359,179,3,Technology,Copiers,180,180,537
AZ-2011-9995644,27,11,4,Office Supplies,Labels,16,16,44
AZ-2011-9995644,92,11,4,Office Supplies,Storage,81,81,44
AZ-2011-9995644,38,10,1,Office Supplies,Supplies,28,28,10
AZ-2011-9996962,26,5,1,Office Supplies,Paper,21,21,5
AZ-2012-1000632,314,22,6,Technology,Machines,292,292,132
AZ-2012-1021775,48,5,3,Office Supplies,Storage,43,43,15
AZ-2012-1023749,107,0,2,Office Supplies,Art,107,107,0
AZ-2012-1028247,1952,759,4,Office Supplies,Appliances,1193,1193,3036
AZ-2012-1031006,264,18,5,Furniture,Chairs,246,246,90
AZ-2012-1063312,837,288,2,Furniture,Chairs,549,549,576
AZ-2012-1068489,27,11,4,Office Supplies,Binders,16,16,44
AZ-2012-1068489,41,7,3,Office Supplies,Supplies,34,34,21
AZ-2012-1071791,28,4,2,Office Supplies,Storage,24,24,8
AZ-2012-1089029,64,24,2,Office Supplies,Binders,40,40,48
AZ-2012-1100963,206,99,4,Furniture,Furnishings,107,107,396
AZ-2012-1100963,27,9,1,Office Supplies,Envelopes,18,18,9
AZ-2012-1100963,9,3,2,Office Supplies,Labels,6,6,6
AZ-2012-1116063,54,27,2,Office Supplies,Art,27,27,54
AZ-2012-1116063,115,10,3,Office Supplies,Envelopes,105,105,30
AZ-2012-1125061,713,40,4,Furniture,Bookcases,673,673,160
AZ-2012-1125061,1676,206,6,Furniture,Tables,1470,1470,1236
AZ-2012-1125061,1141,239,3,Technology,Copiers,902,902,717
AZ-2012-1128813,852,180,2,Furniture,Chairs,672,672,360
AZ-2012-1128813,132,26,5,Office Supplies,Paper,106,106,130
AZ-2012-1169269,145,7,5,Office Supplies,Supplies,138,138,35
AZ-2012-1176951,222,81,3,Furniture,Chairs,141,141,243
AZ-2012-1176951,837,419,7,Technology,Copiers,418,418,2933
AZ-2012-1210526,45,18,3,Office Supplies,Fasteners,27,27,54
AZ-2012-1210526,315,129,3,Technology,Accessories,186,186,387
AZ-2012-1210526,492,-254,6,Technology,Phones,746,746,-1524
AZ-2012-1214247,56,13,5,Office Supplies,Art,43,43,65
AZ-2012-1214247,493,54,10,Office Supplies,Binders,439,439,540
AZ-2012-1214247,148,21,7,Office Supplies,Envelopes,39,127,147
AZ-2012-1214247,33,8,3,Office Supplies,Labels,25,25,24
AZ-2012-1214247,42,7,2,Office Supplies,Paper,35,35,14
AZ-2012-1234027,221,37,2,Furniture,Bookcases,184,184,74
AZ-2012-1234027,170,0,5,Technology,Machines,170,170,0
AZ-2012-1264842,27,4,2,Office Supplies,Paper,23,23,8
AZ-2012-1264842,297,133,2,Technology,Copiers,164,164,266
AZ-2012-1291108,316,95,7,Technology,Accessories,221,221,665
AZ-2012-1295190,48,2,4,Office Supplies,Binders,46,46,8
AZ-2012-1295190,41,6,5,Office Supplies,Labels,35,35,30
AZ-2012-1295190,34,13,2,Office Supplies,Paper,21,21,26
AZ-2012-130560,415,116,8,Furniture,Furnishings,299,299,928
AZ-2012-130560,720,22,12,Office Supplies,Appliances,698,698,264
AZ-2012-130560,304,7,12,Office Supplies,Binders,149,297,84
AZ-2012-130560,40,20,2,Office Supplies,Fasteners,20,20,40
AZ-2012-1332956,10,2,2,Office Supplies,Binders,8,8,4
AZ-2012-1345177,95,30,7,Office Supplies,Binders,65,65,210
AZ-2012-1381532,96,4,6,Office Supplies,Art,92,92,24
AZ-2012-1383136,231,72,2,Furniture,Chairs,159,159,144
AZ-2012-1383136,132,43,3,Furniture,Furnishings,89,89,129
AZ-2012-1383136,42,12,3,Office Supplies,Fasteners,30,30,36
AZ-2012-1383136,223,27,3,Technology,Phones,196,196,81
AZ-2012-1384940,1310,73,4,Furniture,Bookcases,1237,1237,292
AZ-2012-1384940,45,0,2,Office Supplies,Art,45,45,0
AZ-2012-1392278,83,12,3,Office Supplies,Art,71,71,36
AZ-2012-1406543,87,36,5,Office Supplies,Art,51,51,180
AZ-2012-1411846,57,23,5,Office Supplies,Fasteners,34,34,115
AZ-2012-1411846,28,0,3,Office Supplies,Labels,28,28,0
AZ-2012-1418024,712,320,5,Furniture,Bookcases,392,392,1600
AZ-2012-1418024,1062,181,2,Furniture,Tables,881,881,362
AZ-2012-1418024,158,30,3,Office Supplies,Art,128,128,90
AZ-2012-1418024,230,25,6,Technology,Accessories,205,205,150
AZ-2012-1418024,380,84,5,Technology,Phones,296,296,420
AZ-2012-1437670,336,42,15,Office Supplies,Art,23,294,630
AZ-2012-1472059,610,207,5,Furniture,Bookcases,403,403,1035
AZ-2012-1472059,120,7,1,Technology,Copiers,113,113,7
AZ-2012-1485221,256,100,2,Furniture,Bookcases,156,156,200
AZ-2012-1485221,298,71,6,Office Supplies,Art,227,227,426
AZ-2012-1485221,108,4,9,Office Supplies,Binders,104,104,36
AZ-2012-1500509,11,1,1,Office Supplies,Art,10,10,1
AZ-2012-1537388,876,228,2,Furniture,Bookcases,648,648,456
AZ-2012-1561905,176,19,3,Technology,Accessories,157,157,57
AZ-2012-1576083,143,60,12,Office Supplies,Art,83,83,720
AZ-2012-1577687,31,2,2,Office Supplies,Binders,29,29,4
AZ-2012-1605480,769,299,6,Furniture,Bookcases,470,470,1794
AZ-2012-1605480,15,1,2,Office Supplies,Labels,14,14,2
AZ-2012-1622139,796,296,20,Office Supplies,Art,57,500,5920
AZ-2012-1622139,50,17,3,Office Supplies,Fasteners,23,33,51
AZ-2012-1627785,37,12,3,Office Supplies,Labels,25,25,36
AZ-2012-1629233,21,11,3,Office Supplies,Binders,10,10,33
AZ-2012-1643154,1853,576,5,Furniture,Bookcases,1277,1277,2880
AZ-2012-1648520,1024,92,6,Furniture,Bookcases,932,932,552
AZ-2012-1651078,559,118,2,Technology,Machines,441,441,236
AZ-2012-1667717,84,3,3,Office Supplies,Art,81,81,9
AZ-2012-1672161,24,5,2,Office Supplies,Labels,19,19,10
AZ-2012-1672161,49,8,1,Office Supplies,Storage,41,41,8
AZ-2012-1680064,96,35,6,Office Supplies,Art,61,61,210
AZ-2012-1696586,82,23,3,Office Supplies,Binders,59,59,69
AZ-2012-1710081,79,2,3,Office Supplies,Art,77,77,6
AZ-2012-171194,51,15,1,Office Supplies,Art,36,36,15
AZ-2012-1714781,467,-26,3,Furniture,Bookcases,493,493,-78
AZ-2012-1714781,431,-46,4,Technology,Copiers,477,477,-184
AZ-2012-1714781,646,213,3,Technology,Machines,433,433,639
AZ-2012-1722758,2794,516,5,Furniture,Tables,2278,2278,2580
AZ-2012-1722758,43,19,6,Office Supplies,Envelopes,24,24,114
AZ-2012-1751005,225,75,3,Office Supplies,Appliances,150,150,225
AZ-2012-1759709,46,3,3,Office Supplies,Supplies,43,43,9
AZ-2012-1774034,30,14,4,Office Supplies,Binders,16,16,56
AZ-2012-1787398,53,20,1,Furniture,Furnishings,33,33,20
AZ-2012-1789531,81,36,2,Office Supplies,Paper,45,45,72
AZ-2012-1801212,257,33,2,Technology,Copiers,224,224,66
AZ-2012-1810265,201,62,4,Furniture,Furnishings,139,139,248
AZ-2012-1810265,87,10,3,Office Supplies,Art,77,77,30
AZ-2012-1810265,94,38,3,Office Supplies,Paper,56,56,114
AZ-2012-1814143,831,-83,2,Furniture,Chairs,914,914,-166
AZ-2012-1814143,29,14,2,Office Supplies,Supplies,15,15,28
AZ-2012-1817772,880,387,8,Furniture,Furnishings,493,493,3096
AZ-2012-1821964,12,2,1,Office Supplies,Fasteners,10,10,2
AZ-2012-184298,11,2,1,Office Supplies,Fasteners,9,9,2
AZ-2012-1850952,101,33,7,Office Supplies,Art,68,68,231
AZ-2012-1880028,2907,1130,6,Office Supplies,Appliances,1777,1777,6780
AZ-2012-1880028,38,18,3,Office Supplies,Envelopes,20,20,54
AZ-2012-1880028,208,37,4,Office Supplies,Storage,171,171,148
AZ-2012-1880028,220,40,2,Technology,Accessories,180,180,80
AZ-2012-1883755,106,28,5,Office Supplies,Storage,78,78,140
AZ-2012-1904492,11,2,1,Office Supplies,Fasteners,9,9,2
AZ-2012-1940547,14,3,2,Office Supplies,Binders,11,11,6
AZ-2012-1946640,242,29,5,Office Supplies,Binders,213,213,145
AZ-2012-1949462,91,31,3,Office Supplies,Art,60,60,93
AZ-2012-1949462,92,15,4,Office Supplies,Envelopes,77,77,60
AZ-2012-1949462,14,4,3,Office Supplies,Labels,10,10,12
AZ-2012-1951858,44,0,2,Furniture,Furnishings,44,44,0
AZ-2012-1951858,112,17,4,Office Supplies,Paper,95,95,68
AZ-2012-1952755,194,24,3,Furniture,Chairs,170,170,72
AZ-2012-1952755,178,59,7,Office Supplies,Art,119,119,413
AZ-2012-1952755,143,6,2,Technology,Accessories,137,137,12
AZ-2012-1952755,1298,65,9,Technology,Copiers,1233,1233,585
AZ-2012-1964182,50,14,1,Technology,Machines,36,36,14
AZ-2012-1968371,350,97,13,Office Supplies,Art,58,253,1261
AZ-2012-1968371,1491,74,5,Technology,Copiers,1417,1417,370
AZ-2012-19748,2584,660,7,Furniture,Bookcases,1924,1924,4620
AZ-2012-1978129,257,31,5,Furniture,Furnishings,226,226,155
AZ-2012-1978129,104,39,3,Office Supplies,Appliances,65,65,117
AZ-2012-1978129,85,17,4,Office Supplies,Art,48,68,68
AZ-2012-1978129,18,9,4,Office Supplies,Binders,9,9,36
AZ-2012-1978129,119,45,3,Office Supplies,Envelopes,74,74,135
AZ-2012-1978129,46,3,4,Office Supplies,Labels,43,43,12
AZ-2012-1978129,179,69,1,Office Supplies,Storage,110,110,69
AZ-2012-1978129,223,27,3,Technology,Phones,196,196,81
AZ-2012-1979551,69,18,1,Office Supplies,Appliances,51,51,18
AZ-2012-1979551,683,61,5,Technology,Phones,622,622,305
AZ-2012-1988121,26,8,2,Office Supplies,Binders,18,18,16
AZ-2012-1988121,28,0,3,Office Supplies,Labels,28,28,0
AZ-2012-1988121,60,3,3,Office Supplies,Storage,57,57,9
AZ-2012-1999567,560,44,3,Office Supplies,Storage,516,516,132
AZ-2012-2003221,42,16,3,Office Supplies,Fasteners,26,26,48
AZ-2012-202734,157,59,3,Office Supplies,Storage,98,98,177
AZ-2012-2038976,893,347,5,Office Supplies,Storage,546,546,1735
AZ-2012-2040826,103,30,2,Furniture,Furnishings,73,73,60
AZ-2012-2040826,28,6,2,Office Supplies,Fasteners,22,22,12
AZ-2012-2050353,1246,41,5,Furniture,Bookcases,967,1205,205
AZ-2012-2050353,78,35,7,Office Supplies,Labels,43,43,245
AZ-2012-2050353,147,19,5,Technology,Accessories,128,128,95
AZ-2012-207540,129,46,3,Technology,Accessories,83,83,138
AZ-2012-2100184,147,66,3,Furniture,Furnishings,81,81,198
AZ-2012-2100184,202,91,7,Office Supplies,Binders,111,111,637
AZ-2012-2100184,381,144,2,Office Supplies,Storage,237,237,288
AZ-2012-2100184,307,64,3,Technology,Accessories,243,243,192
AZ-2012-2124025,1207,36,4,Technology,Machines,1171,1171,144
AZ-2012-2130534,61,28,2,Office Supplies,Binders,33,33,56
AZ-2012-2130534,42,13,2,Office Supplies,Envelopes,29,29,26
AZ-2012-2145523,39,7,4,Office Supplies,Storage,32,32,28
AZ-2012-2184754,44,11,1,Office Supplies,Storage,33,33,11
AZ-2012-2185703,2489,274,9,Office Supplies,Appliances,2215,2215,2466
AZ-2012-2187904,99,10,2,Office Supplies,Envelopes,89,89,20
AZ-2012-2187904,1003,354,7,Technology,Copiers,649,649,2478
AZ-2012-2193596,34,15,3,Office Supplies,Labels,19,19,45
AZ-2012-2193596,140,4,3,Office Supplies,Supplies,136,136,12
AZ-2012-219498,269,62,9,Office Supplies,Art,207,207,558
AZ-2012-2201530,112,12,5,Office Supplies,Envelopes,100,100,60
AZ-2012-2214403,1527,475,8,Office Supplies,Storage,1052,1052,3800
AZ-2012-2222436,97,17,2,Office Supplies,Art,80,80,34
AZ-2012-2224198,41,20,3,Office Supplies,Fasteners,21,21,60
AZ-2012-2224198,225,29,2,Technology,Accessories,196,196,58
AZ-2012-2227616,219,15,5,Furniture,Furnishings,204,204,75
AZ-2012-2227616,269,21,5,Office Supplies,Art,248,248,105
AZ-2012-2227616,294,-64,3,Technology,Machines,358,358,-192
AZ-2012-2278867,27,11,2,Office Supplies,Fasteners,16,16,22
AZ-2012-2293554,97,0,2,Office Supplies,Storage,97,97,0
AZ-2012-2306577,253,73,5,Office Supplies,Art,180,180,365
AZ-2012-2306577,571,-19,3,Office Supplies,Storage,590,590,-57
AZ-2012-2306577,1913,536,3,Technology,Phones,1377,1377,1608
AZ-2012-231557,180,38,4,Furniture,Furnishings,142,142,152
AZ-2012-2335503,172,-58,1,Furniture,Tables,230,230,-58
AZ-2012-2335503,1952,759,4,Office Supplies,Appliances,1193,1193,3036
AZ-2012-2335503,249,70,5,Office Supplies,Binders,179,179,350
AZ-2012-2335503,130,-20,4,Technology,Machines,150,150,-80
AZ-2012-2342130,119,14,5,Office Supplies,Envelopes,105,105,70
AZ-2012-2345149,119,12,5,Office Supplies,Paper,107,107,60
AZ-2012-2350384,303,6,6,Furniture,Furnishings,297,297,36
AZ-2012-2350384,224,-86,5,Technology,Phones,310,310,-430
AZ-2012-2353592,1022,61,6,Furniture,Bookcases,961,961,366
AZ-2012-2353592,104,38,4,Office Supplies,Paper,24,66,152
AZ-2012-2353592,170,-40,2,Office Supplies,Storage,210,210,-80
AZ-2012-2357034,915,-99,3,Furniture,Tables,1014,1014,-297
AZ-2012-2357034,76,23,5,Office Supplies,Envelopes,53,53,115
AZ-2012-2363041,14,-1,2,Office Supplies,Fasteners,15,15,-2
AZ-2012-2380607,68,14,6,Office Supplies,Fasteners,31,54,84
AZ-2012-2380607,218,7,5,Office Supplies,Storage,211,211,35
AZ-2012-2408041,36,9,3,Office Supplies,Envelopes,27,27,27
AZ-2012-2411878,423,36,5,Office Supplies,Storage,210,387,180
AZ-2012-2411878,87,7,2,Office Supplies,Supplies,80,80,14
AZ-2012-2413231,98,30,2,Office Supplies,Storage,68,68,60
AZ-2012-2417161,278,39,5,Furniture,Furnishings,96,239,195
AZ-2012-2417161,56,11,4,Office Supplies,Art,14,45,44
AZ-2012-2417161,315,57,6,Office Supplies,Paper,258,258,342
AZ-2012-2417161,171,-4,4,Office Supplies,Storage,175,175,-16
AZ-2012-2417161,508,203,2,Technology,Accessories,305,305,406
AZ-2012-2419609,32,5,2,Office Supplies,Storage,27,27,10
AZ-2012-2419609,157,3,3,Technology,Machines,154,154,9
AZ-2012-2424025,255,74,5,Office Supplies,Binders,181,181,370
AZ-2012-2425717,30,4,2,Office Supplies,Binders,26,26,8
AZ-2012-2425717,66,4,3,Office Supplies,Supplies,62,62,12
AZ-2012-2434811,54,15,2,Office Supplies,Supplies,39,39,30
AZ-2012-2440609,651,241,6,Furniture,Furnishings,410,410,1446
AZ-2012-2445606,102,13,2,Office Supplies,Art,89,89,26
AZ-2012-2449827,54,18,3,Office Supplies,Art,36,36,54
AZ-2012-2449827,25,1,4,Office Supplies,Binders,24,24,4
AZ-2012-2449827,442,84,4,Technology,Machines,358,358,336
AZ-2012-2450675,334,107,2,Technology,Phones,227,227,214
AZ-2012-2462721,45,15,5,Office Supplies,Labels,30,30,75
AZ-2012-2465302,103,9,2,Office Supplies,Binders,94,94,18
AZ-2012-2467107,120,51,1,Furniture,Chairs,69,69,51
AZ-2012-2467107,2364,-218,4,Furniture,Tables,2582,2582,-872
AZ-2012-2467107,43,22,4,Office Supplies,Labels,21,21,88
AZ-2012-2484319,91,14,3,Office Supplies,Art,77,77,42
AZ-2012-2492016,16,0,1,Office Supplies,Art,16,16,0
AZ-2012-2492016,187,71,1,Office Supplies,Storage,116,116,71
AZ-2012-2500695,60,29,3,Office Supplies,Envelopes,31,31,87
AZ-2012-2500695,446,109,6,Technology,Phones,337,337,654
AZ-2012-250360,3979,1990,7,Office Supplies,Appliances,1989,1989,13930
AZ-2012-250360,44,13,3,Office Supplies,Fasteners,31,31,39
AZ-2012-250360,428,193,3,Technology,Copiers,235,235,579
AZ-2012-2513839,766,315,7,Furniture,Bookcases,451,451,2205
AZ-2012-2513839,61,30,2,Office Supplies,Envelopes,31,31,60
AZ-2012-2513839,454,-75,2,Technology,Machines,529,529,-150
AZ-2012-252256,2546,382,7,Furniture,Bookcases,2164,2164,2674
AZ-2012-252256,48,3,3,Office Supplies,Envelopes,45,45,9
AZ-2012-252256,138,-76,4,Office Supplies,Storage,214,214,-304
AZ-2012-252256,154,41,8,Office Supplies,Supplies,82,113,328
AZ-2012-2537589,259,47,5,Office Supplies,Binders,212,212,235
AZ-2012-2537589,21,7,3,Office Supplies,Labels,14,14,21
AZ-2012-2540881,37,7,3,Office Supplies,Fasteners,30,30,21
AZ-2012-2580887,209,48,7,Office Supplies,Art,161,161,336
AZ-2012-2580887,117,33,6,Office Supplies,Paper,84,84,198
AZ-2012-2580887,42,17,3,Office Supplies,Storage,25,25,51
AZ-2012-2590055,1003,-55,15,Furniture,Chairs,803,1058,-825
AZ-2012-2590055,131,27,4,Office Supplies,Paper,104,104,108
AZ-2012-2626732,153,70,11,Office Supplies,Fasteners,83,83,770
AZ-2012-2636461,324,110,6,Office Supplies,Art,214,214,660
AZ-2012-2652453,562,50,8,Technology,Accessories,512,512,400
AZ-2012-2667819,147,72,5,Office Supplies,Envelopes,75,75,360
AZ-2012-2675559,71,25,3,Office Supplies,Storage,46,46,75
AZ-2012-2676448,100,27,8,Office Supplies,Binders,58,73,216
AZ-2012-270116,377,83,3,Technology,Copiers,294,294,249
AZ-2012-2712293,548,88,15,Office Supplies,Art,249,460,1320
AZ-2012-2742520,236,92,6,Office Supplies,Art,86,144,552
AZ-2012-2742520,120,30,6,Office Supplies,Envelopes,90,90,180
AZ-2012-2744098,73,3,5,Office Supplies,Binders,70,70,15
AZ-2012-2744098,186,0,7,Office Supplies,Paper,186,186,0
AZ-2012-2751924,102,16,3,Office Supplies,Supplies,86,86,48
AZ-2012-2772170,198,59,7,Office Supplies,Binders,139,139,413
AZ-2012-2801511,309,127,4,Furniture,Chairs,182,182,508
AZ-2012-2801511,174,4,4,Office Supplies,Binders,170,170,16
AZ-2012-2801511,48,1,2,Office Supplies,Envelopes,47,47,2
AZ-2012-2807686,1579,614,4,Furniture,Bookcases,965,965,2456
AZ-2012-2814232,70,29,4,Office Supplies,Art,41,41,116
AZ-2012-2814232,35,18,5,Office Supplies,Binders,17,17,90
AZ-2012-2814232,52,11,5,Office Supplies,Fasteners,41,41,55
AZ-2012-2823287,124,-105,4,Office Supplies,Storage,229,229,-420
AZ-2012-2827318,188,75,3,Office Supplies,Appliances,113,113,225
AZ-2012-2839783,27,7,1,Office Supplies,Art,20,20,7
AZ-2012-2839783,45,-3,2,Office Supplies,Envelopes,48,48,-6
AZ-2012-2839783,55,22,3,Office Supplies,Paper,33,33,66
AZ-2012-2854166,1243,345,3,Furniture,Chairs,898,898,1035
AZ-2012-2854166,60,10,2,Office Supplies,Art,50,50,20
AZ-2012-2854166,72,35,5,Office Supplies,Fasteners,37,37,175
AZ-2012-2860153,501,75,3,Technology,Phones,426,426,225
AZ-2012-2884340,99,41,5,Office Supplies,Art,58,58,205
AZ-2012-2884340,42,12,5,Office Supplies,Binders,30,30,60
AZ-2012-2884340,170,73,2,Technology,Accessories,97,97,146
AZ-2012-2904256,17,1,1,Office Supplies,Storage,16,16,1
AZ-2012-2918666,293,44,2,Furniture,Bookcases,249,249,88
AZ-2012-2918666,50,3,1,Office Supplies,Binders,47,47,3
AZ-2012-2918666,60,2,4,Office Supplies,Paper,58,58,8
AZ-2012-2921507,80,38,4,Furniture,Furnishings,42,42,152
AZ-2012-2921507,338,37,7,Office Supplies,Paper,301,301,259
AZ-2012-2921507,114,8,3,Technology,Accessories,106,106,24
AZ-2012-2928633,45,13,1,Office Supplies,Supplies,32,32,13
AZ-2012-2938834,60,27,3,Office Supplies,Supplies,33,33,81
AZ-2012-2950008,34,9,4,Office Supplies,Binders,25,25,36
AZ-2012-2950008,1239,14,9,Technology,Machines,1225,1225,126
AZ-2012-2961412,53,-19,3,Furniture,Furnishings,72,72,-57
AZ-2012-2961412,95,47,2,Office Supplies,Envelopes,48,48,94
AZ-2012-2961412,900,360,3,Technology,Copiers,540,540,1080
AZ-2012-2961412,716,36,5,Technology,Phones,680,680,180
AZ-2012-2970891,1345,329,3,Office Supplies,Appliances,1016,1016,987
AZ-2012-2970891,69,1,1,Technology,Accessories,68,68,1
AZ-2012-2976788,41,7,3,Office Supplies,Supplies,34,34,21
AZ-2012-3002893,416,68,4,Technology,Machines,348,348,272
AZ-2012-3008162,215,11,9,Office Supplies,Paper,204,204,99
AZ-2012-3019751,363,130,7,Furniture,Furnishings,233,233,910
AZ-2012-3019751,18,2,3,Office Supplies,Binders,16,16,6
AZ-2012-302148,994,-398,7,Furniture,Tables,1392,1392,-2786
AZ-2012-302148,136,-79,2,Office Supplies,Storage,215,215,-158
AZ-2012-302918,104,29,2,Furniture,Furnishings,75,75,58
AZ-2012-3030732,76,30,3,Furniture,Furnishings,46,46,90
AZ-2012-3030732,859,-790,2,Furniture,Tables,1649,1649,-1580
AZ-2012-3030732,182,-27,11,Office Supplies,Storage,31,209,-297
AZ-2012-3042149,32,1,2,Office Supplies,Art,31,31,2
AZ-2012-3045764,24,11,5,Office Supplies,Binders,13,13,55
AZ-2012-3048240,415,66,5,Technology,Accessories,349,349,330
AZ-2012-3052351,248,82,5,Office Supplies,Art,166,166,410
AZ-2012-3052351,182,84,6,Office Supplies,Binders,98,98,504
AZ-2012-3052351,88,-41,2,Technology,Phones,129,129,-82
AZ-2012-3052535,58,23,3,Office Supplies,Fasteners,35,35,69
AZ-2012-3052535,53,22,2,Office Supplies,Storage,31,31,44
AZ-2012-3052535,117,14,3,Office Supplies,Supplies,103,103,42
AZ-2012-3082867,172,74,2,Office Supplies,Appliances,98,98,148
AZ-2012-3082867,258,25,5,Office Supplies,Art,83,233,125
AZ-2012-3082867,151,9,3,Office Supplies,Binders,142,142,27
AZ-2012-3087975,78,-20,3,Office Supplies,Art,98,98,-60
AZ-2012-3087975,116,-7,5,Office Supplies,Supplies,123,123,-35
AZ-2012-3093353,352,67,4,Furniture,Chairs,285,285,268
AZ-2012-3093353,35,8,3,Office Supplies,Binders,27,27,24
AZ-2012-3093353,15,3,1,Office Supplies,Fasteners,12,12,3
AZ-2012-3093353,23,3,2,Office Supplies,Labels,20,20,6
AZ-2012-3104391,14,6,3,Office Supplies,Binders,8,8,18
AZ-2012-3104391,339,129,7,Office Supplies,Paper,210,210,903
AZ-2012-3133492,486,135,3,Furniture,Chairs,351,351,405
AZ-2012-3133492,16,6,2,Office Supplies,Binders,10,10,12
AZ-2012-3133492,85,5,6,Office Supplies,Fasteners,80,80,30
AZ-2012-3133492,187,59,3,Technology,Phones,128,128,177
AZ-2012-3181523,305,51,6,Office Supplies,Storage,254,254,306
AZ-2012-3182076,123,16,3,Furniture,Furnishings,107,107,48
AZ-2012-3182076,53,6,2,Office Supplies,Envelopes,47,47,12
AZ-2012-3182076,200,36,2,Technology,Accessories,164,164,72
AZ-2012-3206190,60,1,5,Office Supplies,Fasteners,59,59,5
AZ-2012-3229399,54,13,4,Office Supplies,Fasteners,41,41,52
AZ-2012-3229399,24,3,1,Office Supplies,Storage,21,21,3
AZ-2012-3239486,406,117,3,Furniture,Bookcases,289,289,351
AZ-2012-3239486,65,20,5,Office Supplies,Binders,45,45,100
AZ-2012-3239486,580,179,10,Technology,Accessories,401,401,1790
AZ-2012-3239511,164,57,2,Office Supplies,Appliances,107,107,114
AZ-2012-3240635,60,17,5,Office Supplies,Binders,10,43,85
AZ-2012-3246904,173,41,8,Office Supplies,Supplies,77,132,328
AZ-2012-3249580,1970,503,6,Furniture,Bookcases,1467,1467,3018
AZ-2012-3249580,34,3,3,Office Supplies,Art,31,31,9
AZ-2012-325160,49,24,1,Furniture,Furnishings,25,25,24
AZ-2012-325160,363,149,3,Office Supplies,Storage,214,214,447
AZ-2012-327072,21,-12,3,Office Supplies,Binders,33,33,-36
AZ-2012-3272403,114,1,2,Office Supplies,Art,113,113,2
AZ-2012-3293299,103,12,2,Furniture,Furnishings,91,91,24
AZ-2012-3293299,2012,-1022,6,Furniture,Tables,3034,3034,-6132
AZ-2012-3293299,328,19,3,Technology,Copiers,309,309,57
AZ-2012-3294671,1972,350,5,Furniture,Bookcases,1622,1622,1750
AZ-2012-331125,69,11,3,Office Supplies,Envelopes,58,58,33
AZ-2012-3319820,310,12,4,Office Supplies,Appliances,298,298,48
AZ-2012-3323986,50,23,5,Office Supplies,Binders,27,27,115
AZ-2012-3333420,285,14,6,Office Supplies,Art,271,271,84
AZ-2012-3333420,252,35,5,Office Supplies,Binders,85,217,175
AZ-2012-3333420,64,30,2,Technology,Accessories,34,34,60
AZ-2012-3337220,50,1,3,Office Supplies,Paper,49,49,3
AZ-2012-3337220,28,5,3,Office Supplies,Storage,23,23,15
AZ-2012-3337220,863,242,7,Technology,Phones,621,621,1694
AZ-2012-334946,95,34,2,Office Supplies,Envelopes,61,61,68
AZ-2012-334946,36,0,4,Office Supplies,Labels,36,36,0
AZ-2012-334946,767,4,10,Office Supplies,Storage,44,763,40
AZ-2012-3365059,42,7,7,Office Supplies,Labels,35,35,49
AZ-2012-3373330,769,154,7,Furniture,Chairs,615,615,1078
AZ-2012-3373330,153,58,3,Furniture,Furnishings,95,95,174
AZ-2012-3373330,64,26,5,Office Supplies,Art,38,38,130
AZ-2012-3373330,72,8,10,Office Supplies,Binders,13,64,80
AZ-2012-3373330,53,-9,4,Office Supplies,Storage,62,62,-36
AZ-2012-3373330,344,15,2,Technology,Copiers,329,329,30
AZ-2012-3380048,134,4,2,Furniture,Chairs,130,130,8
AZ-2012-3380048,43,20,3,Office Supplies,Art,23,23,60
AZ-2012-3385502,1080,36,7,Furniture,Bookcases,1044,1044,252
AZ-2012-3385502,638,172,6,Office Supplies,Storage,71,466,1032
AZ-2012-3389949,478,239,7,Office Supplies,Appliances,239,239,1673
AZ-2012-3389949,178,59,4,Office Supplies,Art,119,119,236
AZ-2012-3389949,511,189,4,Office Supplies,Storage,95,322,756
AZ-2012-3389949,207,4,3,Technology,Accessories,203,203,12
AZ-2012-3398854,290,70,5,Office Supplies,Storage,88,220,350
AZ-2012-3409948,325,124,6,Office Supplies,Storage,201,201,744
AZ-2012-3435538,54,14,3,Office Supplies,Paper,40,40,42
AZ-2012-3435538,1622,324,3,Technology,Phones,1298,1298,972
AZ-2012-3446417,47,15,5,Office Supplies,Storage,32,32,75
AZ-2012-3448109,379,27,2,Technology,Copiers,352,352,54
AZ-2012-3450092,152,19,5,Office Supplies,Art,90,133,95
AZ-2012-3458834,71,1,5,Office Supplies,Art,70,70,5
AZ-2012-3458834,195,-62,6,Office Supplies,Storage,257,257,-372
AZ-2012-3477100,321,-141,5,Office Supplies,Storage,462,462,-705
AZ-2012-3477100,168,-24,11,Technology,Accessories,192,192,-264
AZ-2012-3486509,72,-103,3,Office Supplies,Appliances,175,175,-309
AZ-2012-3486509,389,-217,16,Office Supplies,Binders,301,606,-3472
AZ-2012-3487079,80,18,7,Office Supplies,Art,62,62,126
AZ-2012-3487079,45,4,3,Office Supplies,Binders,41,41,12
AZ-2012-3487079,305,21,8,Technology,Accessories,284,284,168
AZ-2012-3490353,76,21,3,Office Supplies,Art,55,55,63
AZ-2012-3490353,152,46,8,Office Supplies,Binders,37,106,368
AZ-2012-3505333,593,70,5,Technology,Phones,523,523,350
AZ-2012-3505985,34,11,2,Office Supplies,Art,23,23,22
AZ-2012-3505985,698,62,3,Technology,Accessories,636,636,186
AZ-2012-3505985,660,33,10,Technology,Phones,315,627,330
AZ-2012-3506713,122,49,5,Office Supplies,Art,73,73,245
AZ-2012-3506713,102,14,5,Office Supplies,Paper,88,88,70
AZ-2012-3515644,53,2,2,Office Supplies,Art,51,51,4
AZ-2012-3520474,720,50,5,Furniture,Bookcases,670,670,250
AZ-2012-3542766,296,95,7,Office Supplies,Storage,201,201,665
AZ-2012-3581207,2219,25,8,Technology,Machines,2194,2194,200
AZ-2012-358335,15,5,1,Office Supplies,Art,10,10,5
AZ-2012-358335,68,-17,2,Office Supplies,Storage,85,85,-34
AZ-2012-3590299,2105,989,11,Technology,Copiers,1116,1116,10879
AZ-2012-3590299,815,-91,3,Technology,Machines,906,906,-273
AZ-2012-3601642,181,29,6,Office Supplies,Art,152,152,174
AZ-2012-3601642,90,43,4,Office Supplies,Supplies,47,47,172
AZ-2012-3603258,22,0,1,Office Supplies,Art,22,22,0
AZ-2012-3603258,27,4,3,Office Supplies,Labels,23,23,12
AZ-2012-3604436,155,51,5,Technology,Accessories,104,104,255
AZ-2012-3621371,80,19,6,Office Supplies,Fasteners,61,61,114
AZ-2012-3629477,266,61,6,Office Supplies,Supplies,205,205,366
AZ-2012-3630447,10,4,2,Office Supplies,Binders,6,6,8
AZ-2012-3630447,26,1,2,Office Supplies,Fasteners,25,25,2
AZ-2012-3635892,320,147,1,Technology,Copiers,173,173,147
AZ-2012-364031,30,4,2,Office Supplies,Binders,26,26,8
AZ-2012-3654996,51,15,1,Office Supplies,Art,36,36,15
AZ-2012-3654996,58,17,2,Office Supplies,Binders,41,41,34
AZ-2012-3655413,111,24,4,Office Supplies,Paper,87,87,96
AZ-2012-367312,98,49,2,Office Supplies,Art,49,49,98
AZ-2012-3680090,132,36,5,Furniture,Furnishings,96,96,180
AZ-2012-3680090,34,1,2,Office Supplies,Binders,33,33,2
AZ-2012-3680090,144,29,4,Technology,Accessories,115,115,116
AZ-2012-3689624,236,47,6,Office Supplies,Appliances,189,189,282
AZ-2012-3689624,22,1,2,Office Supplies,Labels,21,21,2
AZ-2012-3689624,482,-1,9,Office Supplies,Storage,355,483,-9
AZ-2012-3700237,52,26,2,Office Supplies,Envelopes,26,26,52
AZ-2012-37215,136,9,5,Office Supplies,Art,127,127,45
AZ-2012-3736709,73,-26,3,Office Supplies,Storage,99,99,-78
AZ-2012-3743850,56,27,2,Office Supplies,Paper,29,29,54
AZ-2012-3746179,58,3,4,Office Supplies,Binders,55,55,12
AZ-2012-3751519,325,34,2,Technology,Copiers,291,291,68
AZ-2012-375859,21,7,3,Office Supplies,Binders,14,14,21
AZ-2012-3768744,18,6,3,Office Supplies,Binders,12,12,18
AZ-2012-3768744,44,17,4,Office Supplies,Fasteners,27,27,68
AZ-2012-3772420,167,20,4,Office Supplies,Supplies,147,147,80
AZ-2012-3783663,582,140,3,Furniture,Bookcases,442,442,420
AZ-2012-3813896,48,12,2,Office Supplies,Paper,36,36,24
AZ-2012-3813896,125,40,2,Technology,Phones,85,85,80
AZ-2012-3819043,308,68,7,Office Supplies,Supplies,240,240,476
AZ-2012-3833359,100,28,2,Office Supplies,Binders,72,72,56
AZ-2012-3853973,173,0,5,Office Supplies,Supplies,173,173,0
AZ-2012-385874,52,5,3,Office Supplies,Art,47,47,15
AZ-2012-3906554,518,63,8,Furniture,Chairs,455,455,504
AZ-2012-3913480,906,235,8,Furniture,Furnishings,671,671,1880
AZ-2012-3913480,398,60,7,Office Supplies,Art,338,338,420
AZ-2012-3913480,345,138,7,Office Supplies,Binders,207,207,966
AZ-2012-3919315,343,62,2,Furniture,Bookcases,281,281,124
AZ-2012-3919315,83,2,5,Furniture,Furnishings,81,81,10
AZ-2012-3919315,78,28,6,Office Supplies,Envelopes,50,50,168
AZ-2012-3919315,1169,47,9,Technology,Phones,1122,1122,423
AZ-2012-3931920,249,40,2,Technology,Copiers,209,209,80
AZ-2012-3935458,57,23,3,Office Supplies,Art,34,34,69
AZ-2012-3935458,98,-5,2,Office Supplies,Storage,103,103,-10
AZ-2012-3958452,236,116,2,Technology,Machines,120,120,232
AZ-2012-3965327,79,32,8,Office Supplies,Envelopes,47,47,256
AZ-2012-3970156,20,8,2,Office Supplies,Envelopes,12,12,16
AZ-2012-3973633,48,18,3,Office Supplies,Art,30,30,54
AZ-2012-3981098,33,9,2,Office Supplies,Binders,24,24,18
AZ-2012-398573,412,165,3,Office Supplies,Storage,247,247,495
AZ-2012-3985988,112,4,4,Office Supplies,Art,108,108,16
AZ-2012-3985988,124,4,8,Office Supplies,Binders,120,120,32
AZ-2012-3985988,89,41,4,Office Supplies,Envelopes,48,48,164
AZ-2012-3985988,17,5,1,Office Supplies,Fasteners,12,12,5
AZ-2012-3985988,31,4,3,Office Supplies,Storage,27,27,12
AZ-2012-4005436,683,198,5,Technology,Phones,485,485,990
AZ-2012-400830,666,203,8,Furniture,Furnishings,190,463,1624
AZ-2012-4009939,288,128,6,Office Supplies,Storage,160,160,768
AZ-2012-4011569,103,36,2,Office Supplies,Binders,67,67,72
AZ-2012-4011569,25,8,1,Office Supplies,Envelopes,17,17,8
AZ-2012-4011569,66,4,3,Office Supplies,Supplies,62,62,12
AZ-2012-4052737,61,10,7,Office Supplies,Labels,51,51,70
AZ-2012-4064323,372,186,3,Furniture,Bookcases,186,186,558
AZ-2012-4064323,259,93,5,Furniture,Furnishings,166,166,465
AZ-2012-4064323,668,267,8,Office Supplies,Appliances,401,401,2136
AZ-2012-4064323,1716,583,7,Technology,Copiers,1133,1133,4081
AZ-2012-4085046,21,5,3,Office Supplies,Labels,16,16,15
AZ-2012-4096327,128,0,6,Office Supplies,Envelopes,128,128,0
AZ-2012-4110673,264,119,6,Furniture,Furnishings,145,145,714
AZ-2012-4110673,89,0,3,Office Supplies,Art,89,89,0
AZ-2012-4110673,48,1,3,Office Supplies,Storage,47,47,3
AZ-2012-4110673,527,132,2,Technology,Copiers,395,395,264
AZ-2012-4114446,22,4,2,Office Supplies,Art,18,18,8
AZ-2012-4114446,39,10,3,Office Supplies,Binders,29,29,30
AZ-2012-4141307,115,3,1,Office Supplies,Storage,112,112,3
AZ-2012-4141307,232,35,5,Technology,Accessories,197,197,175
AZ-2012-4148308,42,-20,4,Office Supplies,Storage,62,62,-80
AZ-2012-4148308,48,23,1,Office Supplies,Supplies,25,25,23
AZ-2012-4150074,136,24,3,Furniture,Furnishings,112,112,72
AZ-2012-415740,43,1,2,Office Supplies,Storage,42,42,2
AZ-2012-4158616,74,6,3,Office Supplies,Envelopes,68,68,18
AZ-2012-4161801,159,73,3,Office Supplies,Binders,86,86,219
AZ-2012-4161801,354,174,3,Technology,Machines,180,180,522
AZ-2012-4178346,1629,466,10,Furniture,Bookcases,124,1163,4660
AZ-2012-4178346,27,1,1,Office Supplies,Art,26,26,1
AZ-2012-4178346,242,106,8,Office Supplies,Binders,82,136,848
AZ-2012-4182934,397,194,2,Office Supplies,Storage,203,203,388
AZ-2012-4182934,772,185,4,Technology,Copiers,587,587,740
AZ-2012-4224779,173,44,4,Office Supplies,Storage,129,129,176
AZ-2012-4238116,31,5,2,Office Supplies,Art,26,26,10
AZ-2012-4238116,80,1,7,Office Supplies,Fasteners,79,79,7
AZ-2012-4238116,172,12,3,Office Supplies,Storage,160,160,36
AZ-2012-424456,149,33,3,Furniture,Chairs,116,116,99
AZ-2012-424456,1200,480,4,Technology,Copiers,720,720,1920
AZ-2012-4249351,14,3,2,Office Supplies,Binders,11,11,6
AZ-2012-4260894,44,7,3,Office Supplies,Envelopes,37,37,21
AZ-2012-4265765,59,0,2,Office Supplies,Art,59,59,0
AZ-2012-4265765,407,29,6,Technology,Phones,378,378,174
AZ-2012-4295512,77,22,5,Office Supplies,Binders,55,55,110
AZ-2012-4295512,18,3,2,Office Supplies,Labels,15,15,6
AZ-2012-4295512,92,28,3,Technology,Accessories,64,64,84
AZ-2012-4300696,492,197,10,Office Supplies,Binders,295,295,1970
AZ-2012-4300696,1001,280,6,Technology,Phones,721,721,1680
AZ-2012-4302372,446,0,5,Furniture,Chairs,446,446,0
AZ-2012-4302372,21,4,2,Office Supplies,Labels,17,17,8
AZ-2012-4310145,128,55,1,Office Supplies,Storage,73,73,55
AZ-2012-4411844,183,16,2,Technology,Phones,167,167,32
AZ-2012-4423146,429,57,10,Furniture,Chairs,372,372,570
AZ-2012-4458558,32,8,3,Office Supplies,Binders,24,24,24
AZ-2012-4475228,201,98,4,Furniture,Furnishings,103,103,392
AZ-2012-4475228,274,44,6,Office Supplies,Art,230,230,264
AZ-2012-4476196,116,25,8,Office Supplies,Art,91,91,200
AZ-2012-4476196,118,58,3,Office Supplies,Supplies,60,60,174
AZ-2012-4493461,87,36,3,Office Supplies,Art,51,51,108
AZ-2012-4504749,1478,133,5,Technology,Copiers,1345,1345,665
AZ-2012-4505130,36,-1,1,Furniture,Furnishings,37,37,-1
AZ-2012-4505130,167,67,2,Office Supplies,Appliances,100,100,134
AZ-2012-4505130,102,30,2,Office Supplies,Binders,72,72,60
AZ-2012-4505130,71,9,8,Office Supplies,Labels,34,62,72
AZ-2012-4505130,22,0,2,Office Supplies,Storage,22,22,0
AZ-2012-4505130,1066,224,4,Technology,Machines,842,842,896
AZ-2012-4505130,414,21,3,Technology,Phones,393,393,63
AZ-2012-4512200,99,8,4,Office Supplies,Envelopes,91,91,32
AZ-2012-4512200,368,29,3,Technology,Copiers,339,339,87
AZ-2012-451470,719,273,11,Technology,Phones,446,446,3003
AZ-2012-4522035,54,18,3,Office Supplies,Art,36,36,54
AZ-2012-4522035,259,47,5,Office Supplies,Binders,212,212,235
AZ-2012-4532840,828,406,2,Furniture,Bookcases,422,422,812
AZ-2012-4532840,284,17,7,Office Supplies,Envelopes,267,267,119
AZ-2012-4532840,541,-298,7,Office Supplies,Storage,839,839,-2086
AZ-2012-4561991,46,9,4,Office Supplies,Labels,37,37,36
AZ-2012-4568768,80,11,6,Office Supplies,Storage,69,69,66
AZ-2012-4627785,67,9,4,Office Supplies,Fasteners,58,58,36
AZ-2012-4627785,85,-2,2,Office Supplies,Storage,87,87,-4
AZ-2012-4640221,1514,742,4,Technology,Copiers,772,772,2968
AZ-2012-4642183,248,8,2,Office Supplies,Storage,240,240,16
AZ-2012-464926,23,8,2,Office Supplies,Binders,15,15,16
AZ-2012-4659299,44,10,3,Office Supplies,Art,34,34,30
AZ-2012-4681403,256,53,6,Office Supplies,Storage,27,203,318
AZ-2012-4686001,57,13,3,Office Supplies,Envelopes,44,44,39
AZ-2012-4686001,29,8,2,Office Supplies,Fasteners,21,21,16
AZ-2012-4689385,15,7,2,Office Supplies,Binders,8,8,14
AZ-2012-4697913,651,145,5,Furniture,Chairs,506,506,725
AZ-2012-4697913,38,9,2,Office Supplies,Art,29,29,18
AZ-2012-4697913,56,14,4,Office Supplies,Binders,8,42,56
AZ-2012-4697913,693,254,6,Office Supplies,Storage,439,439,1524
AZ-2012-4707910,168,60,7,Office Supplies,Supplies,108,108,420
AZ-2012-4709370,91,46,3,Office Supplies,Binders,45,45,138
AZ-2012-4709370,35,14,3,Office Supplies,Fasteners,21,21,42
AZ-2012-4709370,24,11,2,Office Supplies,Labels,13,13,22
AZ-2012-4709370,241,-125,3,Office Supplies,Storage,366,366,-375
AZ-2012-4736205,396,131,8,Office Supplies,Art,265,265,1048
AZ-2012-4736205,70,28,5,Office Supplies,Storage,42,42,140
AZ-2012-47402,61,10,7,Office Supplies,Labels,51,51,70
AZ-2012-4743225,488,112,4,Furniture,Bookcases,376,376,448
AZ-2012-4743225,205,3,6,Office Supplies,Storage,202,202,18
AZ-2012-4808160,285,6,2,Technology,Copiers,279,279,12
AZ-2012-4813985,3315,961,7,Furniture,Chairs,2354,2354,6727
AZ-2012-4813985,755,107,12,Technology,Accessories,575,648,1284
AZ-2012-4818460,140,67,8,Furniture,Furnishings,73,73,536
AZ-2012-4818460,28,10,2,Office Supplies,Binders,18,18,20
AZ-2012-4818460,104,17,7,Office Supplies,Storage,87,87,119
AZ-2012-4818460,423,94,4,Technology,Copiers,329,329,376
AZ-2012-4818460,469,182,4,Technology,Phones,287,287,728
AZ-2012-4828217,152,44,3,Office Supplies,Art,108,108,132
AZ-2012-4828873,53,22,2,Office Supplies,Art,31,31,44
AZ-2012-4846430,53,0,2,Office Supplies,Storage,53,53,0
AZ-2012-4853423,86,39,3,Office Supplies,Binders,47,47,117
AZ-2012-4853423,62,29,3,Office Supplies,Paper,33,33,87
AZ-2012-4853423,356,42,3,Technology,Phones,314,314,126
AZ-2012-4857966,126,16,10,Office Supplies,Binders,110,110,160
AZ-2012-4858195,28,1,1,Office Supplies,Art,27,27,1
AZ-2012-4858195,90,17,3,Office Supplies,Binders,73,73,51
AZ-2012-4858195,1211,226,6,Technology,Accessories,180,985,1356
AZ-2012-4863175,201,38,4,Furniture,Furnishings,163,163,152
AZ-2012-4874543,324,10,2,Furniture,Chairs,314,314,20
AZ-2012-4874543,171,80,2,Office Supplies,Appliances,91,91,160
AZ-2012-4874543,326,49,7,Office Supplies,Art,277,277,343
AZ-2012-4874543,125,21,5,Office Supplies,Binders,90,104,105
AZ-2012-4874543,17,6,2,Office Supplies,Labels,11,11,12
AZ-2012-4874543,9,3,1,Office Supplies,Storage,6,6,3
AZ-2012-4874543,246,81,3,Technology,Machines,165,165,243
AZ-2012-490653,28,11,2,Office Supplies,Storage,17,17,22
AZ-2012-4923020,341,31,2,Furniture,Bookcases,310,310,62
AZ-2012-4923020,110,42,9,Office Supplies,Labels,68,68,378
AZ-2012-4954045,136,41,3,Office Supplies,Paper,95,95,123
AZ-2012-4956361,96,22,5,Office Supplies,Art,74,74,110
AZ-2012-4956361,150,25,8,Office Supplies,Envelopes,125,125,200
AZ-2012-4991226,88,27,8,Office Supplies,Labels,61,61,216
AZ-2012-4991226,43,1,1,Office Supplies,Storage,42,42,1
AZ-2012-5001546,257,72,2,Office Supplies,Storage,185,185,144
AZ-2012-5036790,246,25,5,Office Supplies,Supplies,221,221,125
AZ-2012-50424,137,63,3,Office Supplies,Art,74,74,189
AZ-2012-50424,32,14,2,Office Supplies,Envelopes,18,18,28
AZ-2012-5060433,258,75,2,Furniture,Chairs,183,183,150
AZ-2012-5060433,226,99,4,Furniture,Furnishings,127,127,396
AZ-2012-5060433,75,9,3,Office Supplies,Supplies,66,66,27
AZ-2012-506999,53,9,4,Office Supplies,Labels,44,44,36
AZ-2012-5071313,53,17,4,Office Supplies,Art,36,36,68
AZ-2012-5084110,41,11,6,Office Supplies,Binders,30,30,66
AZ-2012-5106565,10,-1,2,Office Supplies,Binders,11,11,-2
AZ-2012-51069,146,46,3,Office Supplies,Storage,100,100,138
AZ-2012-5108667,193,10,11,Furniture,Furnishings,183,183,110
AZ-2012-5108667,561,212,3,Office Supplies,Storage,349,349,636
AZ-2012-5108667,1622,534,3,Technology,Phones,1088,1088,1602
AZ-2012-5117204,54,5,2,Office Supplies,Binders,49,49,10
AZ-2012-5117204,807,305,3,Technology,Machines,502,502,915
AZ-2012-5131347,143,-20,7,Office Supplies,Art,39,163,-140
AZ-2012-5131347,2876,-1783,9,Technology,Phones,4659,4659,-16047
AZ-2012-5138452,1742,261,4,Furniture,Bookcases,1481,1481,1044
AZ-2012-5138452,183,84,4,Office Supplies,Art,99,99,336
AZ-2012-5138452,601,132,13,Office Supplies,Supplies,469,469,1716
AZ-2012-5139893,2123,125,8,Technology,Machines,1998,1998,1000
AZ-2012-514342,14,7,3,Office Supplies,Binders,7,7,21
AZ-2012-5149615,27,12,2,Office Supplies,Binders,15,15,24
AZ-2012-5149615,96,9,2,Office Supplies,Supplies,87,87,18
AZ-2012-5152907,59,25,3,Office Supplies,Art,34,34,75
AZ-2012-5156362,75,1,3,Office Supplies,Art,74,74,3
AZ-2012-5156362,87,2,2,Office Supplies,Binders,85,85,4
AZ-2012-5159296,27,4,2,Office Supplies,Binders,23,23,8
AZ-2012-5159296,82,40,2,Office Supplies,Supplies,42,42,80
AZ-2012-5171390,123,56,4,Office Supplies,Paper,67,67,224
AZ-2012-5171390,45,4,4,Office Supplies,Storage,41,41,16
AZ-2012-517660,148,59,3,Office Supplies,Binders,89,89,177
AZ-2012-517660,56,25,5,Office Supplies,Labels,31,31,125
AZ-2012-5204554,26,10,3,Office Supplies,Fasteners,16,16,30
AZ-2012-5209012,92,6,7,Office Supplies,Binders,86,86,42
AZ-2012-5209012,59,23,9,Office Supplies,Labels,36,36,207
AZ-2012-5209012,191,77,7,Office Supplies,Storage,36,114,539
AZ-2012-5209012,113,54,3,Office Supplies,Supplies,59,59,162
AZ-2012-5209012,397,163,9,Technology,Accessories,234,234,1467
AZ-2012-5215986,85,18,3,Office Supplies,Binders,67,67,54
AZ-2012-5227678,297,47,2,Furniture,Bookcases,250,250,94
AZ-2012-5235693,196,72,3,Technology,Phones,124,124,216
AZ-2012-5240819,820,271,2,Furniture,Bookcases,549,549,542
AZ-2012-5240819,439,79,8,Office Supplies,Art,360,360,632
AZ-2012-5240819,267,128,12,Office Supplies,Storage,139,139,1536
AZ-2012-5240819,93,40,2,Technology,Accessories,53,53,80
AZ-2012-5262260,21,5,2,Office Supplies,Binders,16,16,10
AZ-2012-5292659,53,22,2,Office Supplies,Art,31,31,44
AZ-2012-5304566,18,1,2,Office Supplies,Storage,17,17,2
AZ-2012-5304566,125,54,1,Technology,Phones,71,71,54
AZ-2012-5310150,55,10,1,Office Supplies,Storage,45,45,10
AZ-2012-532125,445,64,1,Office Supplies,Appliances,381,381,64
AZ-2012-532125,272,71,10,Office Supplies,Binders,177,201,710
AZ-2012-532125,101,48,5,Office Supplies,Envelopes,53,53,240
AZ-2012-532125,245,30,2,Office Supplies,Storage,215,215,60
AZ-2012-532125,215,-33,5,Technology,Machines,248,248,-165
AZ-2012-5322178,207,37,5,Furniture,Chairs,170,170,185
AZ-2012-5322178,100,-13,7,Furniture,Furnishings,113,113,-91
AZ-2012-5322178,105,41,4,Technology,Accessories,64,64,164
AZ-2012-534231,586,123,7,Furniture,Chairs,463,463,861
AZ-2012-534231,79,7,3,Office Supplies,Art,72,72,21
AZ-2012-534231,36,9,3,Office Supplies,Envelopes,27,27,27
AZ-2012-5345819,1086,380,3,Furniture,Bookcases,706,706,1140
AZ-2012-5345819,90,19,3,Office Supplies,Paper,71,71,57
AZ-2012-5345939,154,54,3,Office Supplies,Binders,100,100,162
AZ-2012-5345939,108,25,4,Technology,Accessories,83,83,100
AZ-2012-5345939,1639,-154,3,Technology,Phones,1793,1793,-462
AZ-2012-5380367,151,14,3,Furniture,Furnishings,137,137,42
AZ-2012-5380367,124,48,10,Office Supplies,Binders,40,76,480
AZ-2012-5380367,65,9,4,Office Supplies,Storage,56,56,36
AZ-2012-5408714,20,0,2,Office Supplies,Storage,20,20,0
AZ-2012-5408714,2132,533,8,Technology,Machines,1599,1599,4264
AZ-2012-5423873,201,18,4,Furniture,Furnishings,183,183,72
AZ-2012-5423873,14,6,3,Office Supplies,Binders,8,8,18
AZ-2012-5450030,48,2,3,Office Supplies,Art,46,46,6
AZ-2012-5450030,197,85,4,Office Supplies,Binders,112,112,340
AZ-2012-5450030,50,24,4,Office Supplies,Envelopes,26,26,96
AZ-2012-5466506,198,65,4,Office Supplies,Art,133,133,260
AZ-2012-5470762,316,49,3,Technology,Machines,267,267,147
AZ-2012-5494640,103,18,2,Office Supplies,Art,85,85,36
AZ-2012-5499753,56,9,3,Office Supplies,Fasteners,47,47,27
AZ-2012-5515601,1881,301,6,Technology,Machines,1580,1580,1806
AZ-2012-5539179,34,13,2,Office Supplies,Storage,21,21,26
AZ-2012-5539647,34,16,3,Office Supplies,Fasteners,18,18,48
AZ-2012-5539647,96,33,7,Office Supplies,Labels,63,63,231
AZ-2012-5539647,674,303,4,Technology,Copiers,371,371,1212
AZ-2012-5550054,119,4,3,Technology,Accessories,115,115,12
AZ-2012-5575176,40,19,2,Furniture,Furnishings,21,21,38
AZ-2012-5605130,2444,760,5,Office Supplies,Appliances,1684,1684,3800
AZ-2012-5605130,12,0,1,Office Supplies,Art,12,12,0
AZ-2012-5605130,25,0,2,Office Supplies,Labels,25,25,0
AZ-2012-5605130,138,-12,5,Office Supplies,Storage,150,150,-60
AZ-2012-5605130,2167,790,4,Technology,Phones,1377,1377,3160
AZ-2012-5610095,37,2,5,Office Supplies,Labels,35,35,10
AZ-2012-561051,51,12,3,Furniture,Furnishings,39,39,36
AZ-2012-561051,31,10,2,Office Supplies,Art,21,21,20
AZ-2012-561051,355,-4,2,Office Supplies,Storage,359,359,-8
AZ-2012-5610713,393,-326,9,Furniture,Chairs,536,719,-2934
AZ-2012-5610713,25,-4,4,Office Supplies,Art,19,29,-16
AZ-2012-5610713,472,-384,6,Office Supplies,Storage,787,856,-2304
AZ-2012-5610713,189,-155,1,Technology,Copiers,344,344,-155
AZ-2012-5610713,266,-133,2,Technology,Machines,399,399,-266
AZ-2012-5626763,77,13,5,Office Supplies,Art,64,64,65
AZ-2012-5626763,40,0,3,Office Supplies,Labels,40,40,0
AZ-2012-5629458,124,40,5,Office Supplies,Art,84,84,200
AZ-2012-5629716,129,-122,5,Office Supplies,Art,251,251,-610
AZ-2012-5629716,30,-6,3,Office Supplies,Binders,17,36,-18
AZ-2012-5629716,28,-25,4,Office Supplies,Fasteners,53,53,-100
AZ-2012-5631186,1054,337,2,Office Supplies,Appliances,717,717,674
AZ-2012-5631186,153,44,3,Office Supplies,Binders,109,109,132
AZ-2012-5631186,56,8,7,Office Supplies,Labels,48,48,56
AZ-2012-5632093,132,12,5,Office Supplies,Art,120,120,60
AZ-2012-5632093,91,27,6,Office Supplies,Envelopes,64,64,162
AZ-2012-564106,152,25,3,Office Supplies,Storage,127,127,75
AZ-2012-564106,1247,273,5,Technology,Copiers,350,974,1365
AZ-2012-564106,365,117,5,Technology,Phones,248,248,585
AZ-2012-5646456,53,12,2,Office Supplies,Paper,41,41,24
AZ-2012-5646456,89,36,3,Office Supplies,Supplies,53,53,108
AZ-2012-5677067,90,21,3,Office Supplies,Art,69,69,63
AZ-2012-5685113,36,9,3,Office Supplies,Envelopes,27,27,27
AZ-2012-568534,89,14,8,Office Supplies,Binders,55,75,112
AZ-2012-568534,1249,250,4,Technology,Machines,999,999,1000
AZ-2012-569279,189,-11,3,Technology,Copiers,200,200,-33
AZ-2012-5705972,268,67,5,Office Supplies,Art,201,201,335
AZ-2012-5728837,52,1,4,Office Supplies,Fasteners,51,51,4
AZ-2012-5741069,134,31,5,Office Supplies,Storage,103,103,155
AZ-2012-5741069,101,14,2,Technology,Machines,87,87,28
AZ-2012-5752966,5725,2461,9,Technology,Phones,3264,3264,22149
AZ-2012-5763225,719,101,6,Technology,Copiers,618,618,606
AZ-2012-5770966,112,12,5,Office Supplies,Envelopes,100,100,60
AZ-2012-5770966,1081,102,4,Technology,Copiers,979,979,408
AZ-2012-5782432,1081,65,3,Technology,Copiers,1016,1016,195
AZ-2012-581418,141,47,7,Office Supplies,Art,94,94,329
AZ-2012-5821789,560,203,8,Furniture,Chairs,84,357,1624
AZ-2012-5821789,505,-22,2,Office Supplies,Appliances,527,527,-44
AZ-2012-5821789,227,34,4,Office Supplies,Art,193,193,136
AZ-2012-5821789,130,33,3,Office Supplies,Storage,97,97,99
AZ-2012-5826581,100,13,6,Office Supplies,Fasteners,87,87,78
AZ-2012-5846737,43,7,5,Office Supplies,Binders,36,36,35
AZ-2012-5846737,19,8,2,Office Supplies,Labels,11,11,16
AZ-2012-5854289,221,91,7,Office Supplies,Binders,130,130,637
AZ-2012-5854289,166,16,3,Technology,Phones,150,150,48
AZ-2012-5862496,83,29,5,Office Supplies,Paper,27,54,145
AZ-2012-5862496,345,110,8,Office Supplies,Storage,27,235,880
AZ-2012-5894854,316,76,6,Office Supplies,Binders,240,240,456
AZ-2012-5894854,83,29,7,Office Supplies,Labels,31,54,203
AZ-2012-5894854,188,56,3,Office Supplies,Storage,132,132,168
AZ-2012-5894854,100,5,5,Office Supplies,Supplies,50,95,25
AZ-2012-5904307,14,5,1,Office Supplies,Art,9,9,5
AZ-2012-5907386,373,30,3,Furniture,Bookcases,343,343,90
AZ-2012-5907386,74,20,6,Office Supplies,Art,27,54,120
AZ-2012-5907386,34,9,2,Office Supplies,Envelopes,25,25,18
AZ-2012-5907386,769,344,6,Office Supplies,Storage,303,425,2064
AZ-2012-5907386,2550,758,17,Technology,Phones,710,1792,12886
AZ-2012-5924516,42,3,5,Office Supplies,Envelopes,39,39,15
AZ-2012-5992799,150,7,3,Furniture,Chairs,143,143,21
AZ-2012-5992799,623,81,2,Technology,Machines,542,542,162
AZ-2012-5999614,1294,-776,5,Office Supplies,Appliances,2070,2070,-3880
AZ-2012-5999614,164,-7,6,Office Supplies,Art,171,171,-42
AZ-2012-6007479,51,10,3,Office Supplies,Art,18,41,30
AZ-2012-6012259,1394,356,4,Furniture,Bookcases,1038,1038,1424
AZ-2012-6012259,11,0,1,Office Supplies,Binders,11,11,0
AZ-2012-6012259,59,26,4,Office Supplies,Envelopes,33,33,104
AZ-2012-6012259,861,383,8,Technology,Copiers,478,478,3064
AZ-2012-6013472,49,4,1,Furniture,Furnishings,45,45,4
AZ-2012-6013472,29,1,1,Office Supplies,Art,28,28,1
AZ-2012-6013472,65,23,4,Office Supplies,Fasteners,42,42,92
AZ-2012-6013472,38,19,3,Office Supplies,Labels,19,19,57
AZ-2012-6013472,96,12,2,Technology,Accessories,84,84,24
AZ-2012-6013472,221,16,1,Technology,Machines,205,205,16
AZ-2012-6044174,141,48,6,Office Supplies,Art,93,93,288
AZ-2012-6044174,441,110,3,Technology,Copiers,331,331,330
AZ-2012-6044174,1011,162,7,Technology,Phones,849,849,1134
AZ-2012-6068196,16,0,1,Office Supplies,Paper,16,16,0
AZ-2012-6068382,612,159,3,Office Supplies,Storage,453,453,477
AZ-2012-6077999,49,19,4,Office Supplies,Labels,30,30,76
AZ-2012-6077999,246,49,2,Technology,Phones,197,197,98
AZ-2012-6079370,40,7,3,Office Supplies,Labels,33,33,21
AZ-2012-6113257,27,6,3,Office Supplies,Binders,21,21,18
AZ-2012-6113257,36,9,3,Office Supplies,Fasteners,27,27,27
AZ-2012-6191258,2286,846,5,Furniture,Chairs,1440,1440,4230
AZ-2012-6193162,327,116,3,Furniture,Bookcases,211,211,348
AZ-2012-6202346,415,108,2,Office Supplies,Storage,307,307,216
AZ-2012-6214308,304,76,2,Technology,Phones,228,228,152
AZ-2012-6231501,63,14,2,Office Supplies,Supplies,49,49,28
AZ-2012-6233786,82,27,3,Office Supplies,Envelopes,55,55,81
AZ-2012-6233786,680,80,3,Technology,Machines,600,600,240
AZ-2012-6233786,536,44,5,Technology,Phones,492,492,220
AZ-2012-6238242,68,30,1,Furniture,Chairs,38,38,30
AZ-2012-6238242,362,65,7,Office Supplies,Binders,297,297,455
AZ-2012-6238242,231,97,5,Office Supplies,Envelopes,134,134,485
AZ-2012-6238242,297,133,2,Technology,Copiers,164,164,266
AZ-2012-6280455,26,8,2,Office Supplies,Binders,18,18,16
AZ-2012-6280455,68,12,6,Office Supplies,Labels,56,56,72
AZ-2012-6280455,215,77,5,Technology,Accessories,138,138,385
AZ-2012-629185,172,34,2,Technology,Machines,138,138,68
AZ-2012-6297647,161,0,3,Office Supplies,Art,161,161,0
AZ-2012-6341558,30,11,2,Office Supplies,Art,19,19,22
AZ-2012-6341558,402,76,3,Office Supplies,Storage,326,326,228
AZ-2012-6343477,1363,82,8,Furniture,Bookcases,1281,1281,656
AZ-2012-6343477,245,88,5,Office Supplies,Binders,157,157,440
AZ-2012-6343477,173,14,6,Office Supplies,Envelopes,159,159,84
AZ-2012-6343477,22,3,2,Office Supplies,Labels,19,19,6
AZ-2012-6368179,355,79,5,Furniture,Chairs,276,276,395
AZ-2012-6369944,79,39,3,Office Supplies,Envelopes,40,40,117
AZ-2012-6371267,204,59,4,Office Supplies,Binders,145,145,236
AZ-2012-6371267,357,54,3,Office Supplies,Storage,303,303,162
AZ-2012-6372701,26,7,4,Office Supplies,Binders,19,19,28
AZ-2012-6372701,247,82,2,Office Supplies,Storage,165,165,164
AZ-2012-6372701,673,222,3,Technology,Copiers,451,451,666
AZ-2012-6376092,98,28,2,Office Supplies,Art,70,70,56
AZ-2012-6376092,27,8,4,Office Supplies,Binders,19,19,32
AZ-2012-6376092,398,45,9,Office Supplies,Storage,226,353,405
AZ-2012-6376092,218,9,8,Office Supplies,Supplies,209,209,72
AZ-2012-6376256,87,29,6,Office Supplies,Art,58,58,174
AZ-2012-6376256,12,4,2,Office Supplies,Binders,8,8,8
AZ-2012-6376256,24,5,2,Office Supplies,Fasteners,19,19,10
AZ-2012-6401675,100,25,2,Office Supplies,Appliances,75,75,50
AZ-2012-6401675,342,33,12,Office Supplies,Art,201,309,396
AZ-2012-6401675,4748,844,14,Technology,Copiers,3904,3904,11816
AZ-2012-6409303,822,156,2,Furniture,Bookcases,666,666,312
AZ-2012-6409303,97,42,2,Office Supplies,Art,55,55,84
AZ-2012-6411999,14,6,2,Office Supplies,Envelopes,8,8,12
AZ-2012-6415862,152,50,6,Office Supplies,Art,102,102,300
AZ-2012-6415862,7,1,1,Office Supplies,Binders,6,6,1
AZ-2012-6415862,97,29,6,Office Supplies,Supplies,68,68,174
AZ-2012-6415862,503,221,7,Technology,Phones,282,282,1547
AZ-2012-6416816,777,365,3,Technology,Accessories,412,412,1095
AZ-2012-6417191,374,79,14,Office Supplies,Art,159,295,1106
AZ-2012-6417191,49,22,2,Office Supplies,Envelopes,27,27,44
AZ-2012-6417191,28,2,2,Office Supplies,Fasteners,26,26,4
AZ-2012-6445968,399,-263,10,Furniture,Chairs,662,662,-2630
AZ-2012-6449044,64,32,2,Office Supplies,Art,32,32,64
AZ-2012-6468483,123,56,4,Office Supplies,Paper,67,67,224
AZ-2012-649992,451,118,4,Furniture,Chairs,333,333,472
AZ-2012-649992,16,3,1,Office Supplies,Envelopes,13,13,3
AZ-2012-649992,247,-40,5,Office Supplies,Storage,287,287,-200
AZ-2012-6501898,1584,127,3,Office Supplies,Appliances,1457,1457,381
AZ-2012-6501898,31,13,3,Office Supplies,Fasteners,18,18,39
AZ-2012-6501898,83,34,4,Office Supplies,Paper,49,49,136
AZ-2012-650441,320,26,1,Technology,Copiers,294,294,26
AZ-2012-6510788,95,0,7,Office Supplies,Fasteners,95,95,0
AZ-2012-6517579,342,121,3,Furniture,Bookcases,221,221,363
AZ-2012-6517579,62,19,2,Office Supplies,Envelopes,43,43,38
AZ-2012-6517579,169,20,5,Office Supplies,Storage,46,149,100
AZ-2012-6534891,57,13,3,Office Supplies,Art,44,44,39
AZ-2012-6534891,119,53,8,Office Supplies,Binders,66,66,424
AZ-2012-6534891,613,236,7,Technology,Accessories,203,377,1652
AZ-2012-6540731,163,81,6,Office Supplies,Art,82,82,486
AZ-2012-6540731,113,0,4,Office Supplies,Binders,113,113,0
AZ-2012-6540731,52,16,5,Office Supplies,Labels,36,36,80
AZ-2012-6540731,52,-2,1,Office Supplies,Storage,54,54,-2
AZ-2012-6540731,129,46,3,Technology,Accessories,83,83,138
AZ-2012-6540731,554,105,5,Technology,Machines,449,449,525
AZ-2012-6540731,228,48,3,Technology,Phones,180,180,144
AZ-2012-6544927,96,19,4,Office Supplies,Art,77,77,76
AZ-2012-6544927,1071,83,6,Office Supplies,Storage,988,988,498
AZ-2012-6550286,79,36,4,Office Supplies,Supplies,43,43,144
AZ-2012-6550286,312,51,3,Technology,Machines,261,261,153
AZ-2012-6569540,2713,27,7,Furniture,Bookcases,2686,2686,189
AZ-2012-656965,333,76,9,Office Supplies,Envelopes,257,257,684
AZ-2012-656965,73,10,3,Office Supplies,Storage,63,63,30
AZ-2012-6572855,743,256,2,Furniture,Bookcases,487,487,512
AZ-2012-6572855,254,107,3,Furniture,Chairs,147,147,321
AZ-2012-6572855,30,15,3,Office Supplies,Art,15,15,45
AZ-2012-6572855,46,18,4,Office Supplies,Fasteners,28,28,72
AZ-2012-6572855,861,327,5,Technology,Machines,534,534,1635
AZ-2012-6580812,78,27,3,Office Supplies,Art,51,51,81
AZ-2012-6591683,151,29,5,Office Supplies,Binders,122,122,145
AZ-2012-6591683,139,36,3,Office Supplies,Supplies,103,103,108
AZ-2012-6596978,15,5,1,Office Supplies,Art,10,10,5
AZ-2012-661541,90,36,3,Office Supplies,Binders,54,54,108
AZ-2012-6617050,16,4,1,Office Supplies,Fasteners,12,12,4
AZ-2012-6620882,117,6,4,Office Supplies,Art,111,111,24
AZ-2012-6620882,10,4,2,Office Supplies,Binders,6,6,8
AZ-2012-6620882,43,9,3,Office Supplies,Fasteners,34,34,27
AZ-2012-6624087,1394,363,13,Office Supplies,Storage,147,1031,4719
AZ-2012-664111,27,6,2,Office Supplies,Fasteners,21,21,12
AZ-2012-6682844,135,43,3,Office Supplies,Paper,92,92,129
AZ-2012-6682844,56,6,5,Office Supplies,Storage,50,50,30
AZ-2012-6683296,39,-13,2,Office Supplies,Storage,52,52,-26
AZ-2012-6683296,34,-1,3,Office Supplies,Supplies,35,35,-3
AZ-2012-6696550,154,5,1,Furniture,Bookcases,149,149,5
AZ-2012-6744680,58,25,7,Office Supplies,Fasteners,33,33,175
AZ-2012-6744680,21,7,2,Office Supplies,Labels,14,14,14
AZ-2012-6747407,434,143,4,Furniture,Furnishings,291,291,572
AZ-2012-6747407,43,9,4,Office Supplies,Labels,34,34,36
AZ-2012-6747407,425,136,8,Technology,Accessories,289,289,1088
AZ-2012-6749247,74,15,5,Office Supplies,Art,59,59,75
AZ-2012-6749247,45,6,3,Office Supplies,Binders,39,39,18
AZ-2012-6757655,20,6,2,Office Supplies,Fasteners,14,14,12
AZ-2012-6757655,288,13,7,Office Supplies,Storage,38,275,91
AZ-2012-6771393,42,15,3,Office Supplies,Binders,27,27,45
AZ-2012-6814882,319,36,3,Furniture,Chairs,283,283,108
AZ-2012-6815344,36,6,4,Office Supplies,Binders,30,30,24
AZ-2012-6815344,176,79,6,Technology,Accessories,97,97,474
AZ-2012-6827318,415,83,3,Furniture,Chairs,332,332,249
AZ-2012-6849186,11,-2,3,Office Supplies,Labels,13,13,-6
AZ-2012-6913156,30,4,2,Office Supplies,Binders,26,26,8
AZ-2012-6918237,44,9,3,Office Supplies,Art,35,35,27
AZ-2012-6921554,23,4,3,Office Supplies,Labels,9,19,12
AZ-2012-6923537,122,40,6,Office Supplies,Supplies,82,82,240
AZ-2012-6923537,88,40,3,Technology,Accessories,48,48,120
AZ-2012-6962092,66,22,4,Office Supplies,Fasteners,44,44,88
AZ-2012-6962092,147,44,3,Office Supplies,Storage,103,103,132
AZ-2012-6973714,110,20,2,Office Supplies,Art,90,90,40
AZ-2012-6973714,93,15,2,Technology,Accessories,78,78,30
AZ-2012-6992857,35,5,2,Office Supplies,Paper,30,30,10
AZ-2012-6992927,92,39,2,Office Supplies,Envelopes,53,53,78
AZ-2012-6992927,35,4,2,Office Supplies,Storage,31,31,8
AZ-2012-6998703,97,29,2,Office Supplies,Binders,68,68,58
AZ-2012-6999743,1237,99,5,Technology,Accessories,1138,1138,495
AZ-2012-7003401,24,1,2,Office Supplies,Binders,23,23,2
AZ-2012-7003401,61,25,3,Office Supplies,Envelopes,36,36,75
AZ-2012-7003401,288,75,5,Technology,Accessories,133,213,375
AZ-2012-7027662,205,27,5,Furniture,Furnishings,178,178,135
AZ-2012-7029470,249,87,7,Office Supplies,Supplies,162,162,609
AZ-2012-7045480,107,23,9,Office Supplies,Labels,84,84,207
AZ-2012-7062936,1552,109,5,Office Supplies,Appliances,1443,1443,545
AZ-2012-7062936,735,191,6,Technology,Copiers,544,544,1146
AZ-2012-7064171,318,22,9,Office Supplies,Supplies,296,296,198
AZ-2012-7085203,45,0,2,Office Supplies,Art,45,45,0
AZ-2012-7087308,108,41,2,Office Supplies,Storage,67,67,82
AZ-2012-7094138,87,16,2,Office Supplies,Storage,71,71,32
AZ-2012-7120418,74,29,3,Office Supplies,Art,45,45,87
AZ-2012-712520,857,373,8,Office Supplies,Storage,127,484,2984
AZ-2012-7160748,838,0,3,Office Supplies,Appliances,838,838,0
AZ-2012-7160748,376,30,7,Office Supplies,Art,346,346,210
AZ-2012-7160748,200,-40,2,Technology,Phones,240,240,-80
AZ-2012-719087,920,303,3,Technology,Machines,617,617,909
AZ-2012-7198140,63,25,4,Furniture,Furnishings,38,38,100
AZ-2012-7198140,149,36,3,Office Supplies,Art,113,113,108
AZ-2012-7207292,46,20,5,Office Supplies,Binders,26,26,100
AZ-2012-7207292,371,89,9,Office Supplies,Envelopes,282,282,801
AZ-2012-7235775,119,14,1,Technology,Phones,105,105,14
AZ-2012-7237498,40,18,4,Office Supplies,Binders,22,22,72
AZ-2012-7237498,144,23,1,Technology,Phones,121,121,23
AZ-2012-7250654,371,87,1,Furniture,Bookcases,284,284,87
AZ-2012-7250654,88,27,2,Furniture,Furnishings,61,61,54
AZ-2012-7250654,30,12,3,Office Supplies,Envelopes,18,18,36
AZ-2012-7250654,14,6,2,Office Supplies,Labels,8,8,12
AZ-2012-7273357,577,-385,7,Office Supplies,Storage,962,962,-2695
AZ-2012-7273357,231,99,4,Technology,Accessories,132,132,396
AZ-2012-7281587,44,14,1,Furniture,Furnishings,30,30,14
AZ-2012-7281587,14,5,2,Office Supplies,Labels,9,9,10
AZ-2012-7281587,632,-22,5,Technology,Copiers,654,654,-110
AZ-2012-7297045,207,77,4,Office Supplies,Art,130,130,308
AZ-2012-7311439,201,63,3,Furniture,Chairs,138,138,189
AZ-2012-7344517,55,2,2,Office Supplies,Supplies,53,53,4
AZ-2012-7350513,44,10,3,Office Supplies,Art,34,34,30
AZ-2012-7350513,31,4,1,Office Supplies,Paper,27,27,4
AZ-2012-7351228,167,25,8,Office Supplies,Paper,142,142,200
AZ-2012-7356615,62,12,4,Office Supplies,Envelopes,50,50,48
AZ-2012-7356615,30,13,2,Office Supplies,Fasteners,17,17,26
AZ-2012-7356615,214,73,7,Office Supplies,Paper,141,141,511
AZ-2012-7357839,88,18,3,Technology,Accessories,70,70,54
AZ-2012-7359677,78,20,3,Office Supplies,Art,58,58,60
AZ-2012-7359677,27,6,4,Office Supplies,Binders,21,21,24
AZ-2012-7391024,249,60,5,Office Supplies,Art,189,189,300
AZ-2012-7391024,305,57,7,Office Supplies,Storage,248,248,399
AZ-2012-73919,25,12,4,Office Supplies,Labels,13,13,48
AZ-2012-7403782,856,154,5,Furniture,Bookcases,702,702,770
AZ-2012-7403782,88,4,3,Office Supplies,Art,84,84,12
AZ-2012-7403782,20,8,2,Office Supplies,Envelopes,12,12,16
AZ-2012-7403782,30,12,2,Office Supplies,Fasteners,18,18,24
AZ-2012-7403782,697,-23,7,Technology,Machines,720,720,-161
AZ-2012-7407421,22,3,2,Office Supplies,Labels,19,19,6
AZ-2012-741020,53,13,4,Office Supplies,Fasteners,40,40,52
AZ-2012-741020,578,212,5,Office Supplies,Storage,366,366,1060
AZ-2012-7429996,170,26,3,Office Supplies,Art,144,144,78
AZ-2012-7429996,1282,500,5,Technology,Accessories,782,782,2500
AZ-2012-7448408,15,-9,1,Office Supplies,Binders,24,24,-9
AZ-2012-7448408,5,-5,1,Office Supplies,Envelopes,10,10,-5
AZ-2012-7448408,22,-21,3,Office Supplies,Fasteners,43,43,-63
AZ-2012-7461452,65,6,7,Office Supplies,Storage,59,59,42
AZ-2012-7471811,54,12,4,Office Supplies,Supplies,42,42,48
AZ-2012-7477983,973,107,9,Furniture,Furnishings,866,866,963
AZ-2012-7477983,16,7,2,Office Supplies,Binders,9,9,14
AZ-2012-7477983,77,8,4,Office Supplies,Envelopes,69,69,32
AZ-2012-7489217,207,33,2,Technology,Accessories,174,174,66
AZ-2012-7505470,26,8,2,Office Supplies,Binders,18,18,16
AZ-2012-7505470,204,61,5,Office Supplies,Storage,13,143,305
AZ-2012-7520168,94,27,2,Office Supplies,Supplies,67,67,54
AZ-2012-7523947,156,0,3,Furniture,Furnishings,156,156,0
AZ-2012-7523947,438,30,6,Office Supplies,Storage,30,408,180
AZ-2012-7541592,656,-36,2,Furniture,Bookcases,692,692,-72
AZ-2012-7541592,159,60,3,Furniture,Furnishings,99,99,180
AZ-2012-7541592,78,24,6,Office Supplies,Binders,54,54,144
AZ-2012-7541592,305,110,7,Technology,Machines,195,195,770
AZ-2012-7552000,1087,120,3,Furniture,Bookcases,967,967,360
AZ-2012-7556603,68,-64,3,Office Supplies,Art,132,132,-192
AZ-2012-7560485,75,34,4,Furniture,Furnishings,41,41,136
AZ-2012-7560485,105,19,2,Office Supplies,Paper,86,86,38
AZ-2012-7579239,831,108,5,Furniture,Chairs,723,723,540
AZ-2012-7579239,30,1,2,Office Supplies,Paper,29,29,2
AZ-2012-7579239,160,80,3,Office Supplies,Storage,80,80,240
AZ-2012-7586944,76,35,6,Office Supplies,Binders,41,41,210
AZ-2012-7586944,593,284,14,Office Supplies,Envelopes,291,309,3976
AZ-2012-7606477,74,14,7,Office Supplies,Labels,60,60,98
AZ-2012-7631532,371,41,3,Furniture,Bookcases,330,330,123
AZ-2012-7631532,64,17,9,Office Supplies,Binders,21,47,153
AZ-2012-764953,242,39,8,Office Supplies,Art,203,203,312
AZ-2012-7659518,43,4,1,Office Supplies,Storage,39,39,4
AZ-2012-7671653,460,-21,3,Furniture,Bookcases,481,481,-63
AZ-2012-7671653,78,30,2,Furniture,Chairs,48,48,60
AZ-2012-7671653,620,21,5,Office Supplies,Storage,599,599,105
AZ-2012-7674901,107,27,2,Office Supplies,Art,80,80,54
AZ-2012-7674901,625,29,9,Technology,Phones,596,596,261
AZ-2012-7677326,132,34,3,Office Supplies,Storage,98,98,102
AZ-2012-768602,36,9,3,Office Supplies,Envelopes,27,27,27
AZ-2012-7693898,791,-53,2,Furniture,Bookcases,844,844,-106
AZ-2012-7693898,99,33,2,Office Supplies,Art,66,66,66
AZ-2012-771628,492,187,2,Technology,Accessories,305,305,374
AZ-2012-7753558,1142,411,2,Office Supplies,Appliances,731,731,822
AZ-2012-7753558,113,30,3,Office Supplies,Envelopes,83,83,90
AZ-2012-7753558,1283,603,5,Technology,Accessories,680,680,3015
AZ-2012-7754388,714,309,4,Office Supplies,Storage,405,405,1236
AZ-2012-7754388,320,16,1,Technology,Copiers,304,304,16
AZ-2012-7755633,325,32,7,Office Supplies,Paper,293,293,224
AZ-2012-7761604,67,-30,8,Office Supplies,Art,35,97,-240
AZ-2012-7790652,846,141,7,Office Supplies,Storage,46,705,987
AZ-2012-7790652,487,243,2,Technology,Copiers,244,244,486
AZ-2012-7800585,357,20,2,Furniture,Bookcases,337,337,40
AZ-2012-7805058,1145,356,6,Office Supplies,Storage,789,789,2136
AZ-2012-7805058,523,178,3,Technology,Machines,345,345,534
AZ-2012-7806048,1893,928,5,Technology,Copiers,965,965,4640
AZ-2012-7806726,353,7,7,Furniture,Furnishings,346,346,49
AZ-2012-7806726,343,171,7,Office Supplies,Art,172,172,1197
AZ-2012-7826835,57,13,3,Office Supplies,Art,44,44,39
AZ-2012-7826835,244,122,3,Technology,Accessories,122,122,366
AZ-2012-7832440,399,48,2,Furniture,Bookcases,351,351,96
AZ-2012-7832440,89,31,3,Office Supplies,Art,58,58,93
AZ-2012-7832440,23,8,5,Office Supplies,Labels,15,15,40
AZ-2012-7832440,1147,11,9,Office Supplies,Storage,1136,1136,99
AZ-2012-7839714,509,114,3,Office Supplies,Storage,395,395,342
AZ-2012-7850198,35,13,5,Office Supplies,Labels,22,22,65
AZ-2012-7889510,546,114,6,Office Supplies,Appliances,432,432,684
AZ-2012-7919295,327,82,2,Technology,Machines,245,245,164
AZ-2012-7920968,29,1,2,Office Supplies,Binders,28,28,2
AZ-2012-7930986,823,247,2,Furniture,Chairs,576,576,494
AZ-2012-7930986,284,123,14,Office Supplies,Supplies,161,161,1722
AZ-2012-7938746,435,87,3,Furniture,Chairs,348,348,261
AZ-2012-7938746,165,30,3,Office Supplies,Art,135,135,90
AZ-2012-7938746,114,40,7,Office Supplies,Fasteners,74,74,280
AZ-2012-7965791,197,79,4,Office Supplies,Binders,118,118,316
AZ-2012-7971631,244,71,5,Office Supplies,Art,173,173,355
AZ-2012-7989750,42,17,3,Office Supplies,Storage,25,25,51
AZ-2012-7989750,83,4,2,Office Supplies,Supplies,79,79,8
AZ-2012-799342,239,48,7,Office Supplies,Art,125,191,336
AZ-2012-7998703,371,96,8,Office Supplies,Art,275,275,768
AZ-2012-7998703,97,4,2,Office Supplies,Paper,93,93,8
AZ-2012-8028235,377,98,1,Technology,Copiers,279,279,98
AZ-2012-8035281,24,2,4,Office Supplies,Binders,22,22,8
AZ-2012-8039360,50,14,3,Office Supplies,Binders,36,36,42
AZ-2012-8039360,27,9,2,Office Supplies,Fasteners,18,18,18
AZ-2012-8039360,27,4,4,Office Supplies,Labels,23,23,16
AZ-2012-8039360,43,0,4,Office Supplies,Storage,43,43,0
AZ-2012-8039360,254,5,5,Technology,Machines,249,249,25
AZ-2012-8057187,201,16,3,Technology,Phones,185,185,48
AZ-2012-8078342,25,7,3,Office Supplies,Binders,18,18,21
AZ-2012-808163,245,71,2,Technology,Machines,174,174,142
AZ-2012-8111484,56,2,2,Office Supplies,Storage,54,54,4
AZ-2012-8140932,274,103,2,Furniture,Bookcases,171,171,206
AZ-2012-8140932,99,24,2,Office Supplies,Art,75,75,48
AZ-2012-8140932,55,21,5,Office Supplies,Fasteners,34,34,105
AZ-2012-8140932,210,-22,2,Technology,Phones,232,232,-44
AZ-2012-8144166,119,-10,2,Furniture,Chairs,129,129,-20
AZ-2012-8144166,1239,0,4,Office Supplies,Appliances,1239,1239,0
AZ-2012-8144166,97,17,7,Office Supplies,Art,59,80,119
AZ-2012-8144166,65,11,4,Office Supplies,Fasteners,54,54,44
AZ-2012-8169593,750,92,5,Furniture,Bookcases,658,658,460
AZ-2012-8169593,80,8,4,Office Supplies,Art,15,72,32
AZ-2012-8186221,26,8,2,Office Supplies,Art,18,18,16
AZ-2012-8186221,15,3,1,Office Supplies,Fasteners,12,12,3
AZ-2012-8186221,349,105,3,Technology,Accessories,244,244,315
AZ-2012-8186221,636,146,2,Technology,Copiers,490,490,292
AZ-2012-8203288,147,31,5,Office Supplies,Binders,116,116,155
AZ-2012-8255780,88,34,2,Office Supplies,Storage,54,54,68
AZ-2012-8255780,142,45,2,Technology,Machines,97,97,90
AZ-2012-8266486,142,14,3,Office Supplies,Art,128,128,42
AZ-2012-8266486,69,27,6,Office Supplies,Binders,42,42,162
AZ-2012-8267693,2571,857,6,Furniture,Chairs,1714,1714,5142
AZ-2012-8270479,492,44,7,Technology,Accessories,448,448,308
AZ-2012-8270479,373,74,6,Technology,Phones,299,299,444
AZ-2012-827677,12,1,3,Office Supplies,Binders,11,11,3
AZ-2012-8282656,23,0,2,Office Supplies,Fasteners,23,23,0
AZ-2012-8282656,1594,-225,7,Technology,Machines,1819,1819,-1575
AZ-2012-8319286,17,3,2,Office Supplies,Binders,14,14,6
AZ-2012-8319286,53,2,5,Office Supplies,Labels,51,51,10
AZ-2012-8319286,63,31,3,Office Supplies,Paper,32,32,93
AZ-2012-8319286,79,5,4,Office Supplies,Storage,74,74,20
AZ-2012-8319286,1195,155,5,Technology,Copiers,1040,1040,775
AZ-2012-8319286,558,139,4,Technology,Phones,419,419,556
AZ-2012-8352768,1779,711,7,Technology,Accessories,1068,1068,4977
AZ-2012-8353362,212,-265,3,Furniture,Chairs,477,477,-795
AZ-2012-8353362,155,26,3,Office Supplies,Art,129,129,78
AZ-2012-8353362,18,4,2,Office Supplies,Binders,14,14,8
AZ-2012-8353362,357,118,1,Technology,Copiers,239,239,118
AZ-2012-8367812,38,8,2,Office Supplies,Art,30,30,16
AZ-2012-8367812,245,88,5,Office Supplies,Binders,157,157,440
AZ-2012-8367812,136,56,4,Office Supplies,Paper,80,80,224
AZ-2012-8368364,99,12,4,Office Supplies,Supplies,87,87,48
AZ-2012-8369487,140,60,3,Technology,Accessories,80,80,180
AZ-2012-8403206,251,120,2,Furniture,Bookcases,131,131,240
AZ-2012-8403206,40,10,2,Office Supplies,Envelopes,30,30,20
AZ-2012-8403206,79,10,1,Technology,Accessories,69,69,10
AZ-2012-8434539,254,20,6,Furniture,Chairs,234,234,120
AZ-2012-8439638,40,17,2,Office Supplies,Art,23,23,34
AZ-2012-8456579,265,82,5,Furniture,Chairs,183,183,410
AZ-2012-8456579,31,1,2,Office Supplies,Paper,30,30,2
AZ-2012-8459851,28,11,2,Office Supplies,Storage,17,17,22
AZ-2012-8459851,76,20,3,Office Supplies,Supplies,56,56,60
AZ-2012-8459851,1048,-49,4,Technology,Machines,1097,1097,-196
AZ-2012-8465046,7,-1,1,Office Supplies,Binders,8,8,-1
AZ-2012-8512121,100,19,2,Furniture,Furnishings,81,81,38
AZ-2012-8516035,184,33,1,Office Supplies,Storage,151,151,33
AZ-2012-8524723,326,128,9,Office Supplies,Art,167,198,1152
AZ-2012-8524723,52,-2,1,Office Supplies,Storage,54,54,-2
AZ-2012-8524723,245,20,3,Technology,Accessories,225,225,60
AZ-2012-8524723,644,-61,4,Technology,Copiers,705,705,-244
AZ-2012-852937,1285,450,4,Technology,Copiers,835,835,1800
AZ-2012-855132,818,214,8,Office Supplies,Storage,461,604,1712
AZ-2012-8553942,50,13,1,Furniture,Furnishings,37,37,13
AZ-2012-8556389,51,2,8,Office Supplies,Binders,49,49,16
AZ-2012-8565263,1245,162,4,Technology,Machines,1083,1083,648
AZ-2012-8583605,55,12,5,Office Supplies,Labels,43,43,60
AZ-2012-8583605,47,1,3,Office Supplies,Paper,46,46,3
AZ-2012-8583605,205,92,7,Technology,Accessories,113,113,644
AZ-2012-8589004,24,10,5,Office Supplies,Binders,14,14,50
AZ-2012-8594420,322,0,6,Office Supplies,Art,322,322,0
AZ-2012-8617894,207,77,4,Office Supplies,Art,130,130,308
AZ-2012-8617894,110,16,3,Office Supplies,Supplies,94,94,48
AZ-2012-8629398,72,7,7,Office Supplies,Labels,65,65,49
AZ-2012-8629398,384,69,3,Office Supplies,Storage,315,315,207
AZ-2012-8652338,224,72,5,Office Supplies,Paper,152,152,360
AZ-2012-8667424,160,-197,3,Furniture,Chairs,357,357,-591
AZ-2012-8667424,31,-23,2,Office Supplies,Paper,54,54,-46
AZ-2012-869574,135,45,3,Furniture,Chairs,90,90,135
AZ-2012-869574,298,71,6,Office Supplies,Art,227,227,426
AZ-2012-869574,80,8,5,Office Supplies,Storage,72,72,40
AZ-2012-869574,136,68,2,Technology,Phones,68,68,136
AZ-2012-87081,192,47,5,Office Supplies,Binders,79,145,235
AZ-2012-8708707,151,-48,3,Furniture,Chairs,199,199,-144
AZ-2012-8723152,151,36,4,Office Supplies,Storage,115,115,144
AZ-2012-8726889,55,22,7,Office Supplies,Binders,33,33,154
AZ-2012-8726889,260,46,5,Office Supplies,Storage,214,214,230
AZ-2012-8733795,84,22,9,Office Supplies,Binders,62,62,198
AZ-2012-8733795,16,4,1,Office Supplies,Storage,12,12,4
AZ-2012-8733795,133,28,3,Technology,Machines,105,105,84
AZ-2012-873456,170,-4,5,Furniture,Furnishings,174,174,-20
AZ-2012-874954,78,5,7,Office Supplies,Fasteners,73,73,35
AZ-2012-8819621,246,66,2,Technology,Phones,180,180,132
AZ-2012-8875162,440,128,3,Furniture,Bookcases,312,312,384
AZ-2012-8881381,57,23,3,Office Supplies,Art,34,34,69
AZ-2012-8884167,55,17,4,Office Supplies,Fasteners,38,38,68
AZ-2012-8884308,108,43,4,Office Supplies,Envelopes,65,65,172
AZ-2012-8884633,98,42,2,Office Supplies,Binders,56,56,84
AZ-2012-8885396,1058,74,5,Office Supplies,Storage,984,984,370
AZ-2012-8903845,82,7,1,Technology,Accessories,75,75,7
AZ-2012-8910034,275,4,9,Furniture,Furnishings,271,271,36
AZ-2012-8926364,144,65,5,Office Supplies,Binders,79,79,325
AZ-2012-8926364,99,10,2,Office Supplies,Envelopes,89,89,20
AZ-2012-8935419,24,3,3,Office Supplies,Labels,21,21,9
AZ-2012-8935419,248,79,3,Technology,Phones,169,169,237
AZ-2012-8938202,508,208,3,Furniture,Bookcases,300,300,624
AZ-2012-8938202,87,25,3,Office Supplies,Binders,62,62,75
AZ-2012-8938202,41,19,2,Office Supplies,Paper,22,22,38
AZ-2012-8939164,43,15,6,Office Supplies,Binders,28,28,90
AZ-2012-8939164,736,-17,11,Office Supplies,Storage,101,753,-187
AZ-2012-8940474,293,47,5,Furniture,Chairs,246,246,235
AZ-2012-8940474,99,24,2,Office Supplies,Art,75,75,48
AZ-2012-8940474,216,95,3,Technology,Phones,121,121,285
AZ-2012-8977452,151,13,2,Furniture,Chairs,138,138,26
AZ-2012-9018898,80,9,5,Furniture,Furnishings,71,71,45
AZ-2012-9020905,101,38,2,Furniture,Furnishings,63,63,76
AZ-2012-9020905,52,18,2,Office Supplies,Art,34,34,36
AZ-2012-9020905,104,2,5,Office Supplies,Storage,102,102,10
AZ-2012-9024029,27,1,1,Office Supplies,Art,26,26,1
AZ-2012-9037690,87,-35,5,Furniture,Chairs,122,122,-175
AZ-2012-9037690,175,11,7,Office Supplies,Art,164,164,77
AZ-2012-9037690,30,14,1,Office Supplies,Binders,16,16,14
AZ-2012-9049476,34,3,3,Office Supplies,Art,31,31,9
AZ-2012-9049476,12,0,2,Office Supplies,Binders,12,12,0
AZ-2012-9049476,804,-496,5,Technology,Machines,1300,1300,-2480
AZ-2012-9056595,95,33,2,Furniture,Chairs,62,62,66
AZ-2012-9056595,115,25,6,Office Supplies,Fasteners,90,90,150
AZ-2012-9056595,240,21,2,Office Supplies,Storage,219,219,42
AZ-2012-9056595,157,11,3,Technology,Machines,146,146,33
AZ-2012-9062597,345,31,3,Office Supplies,Storage,314,314,93
AZ-2012-9071666,152,76,5,Office Supplies,Binders,76,76,380
AZ-2012-907711,352,-49,8,Furniture,Chairs,401,401,-392
AZ-2012-909274,2944,1112,5,Technology,Phones,1832,1832,5560
AZ-2012-9094578,583,-490,3,Furniture,Bookcases,1073,1073,-1470
AZ-2012-9094578,98,-27,4,Office Supplies,Binders,125,125,-108
AZ-2012-9094578,459,-290,9,Office Supplies,Storage,14,749,-2610
AZ-2012-9094578,126,-41,6,Office Supplies,Supplies,167,167,-246
AZ-2012-910518,34,9,3,Office Supplies,Binders,25,25,27
AZ-2012-910518,1081,356,2,Technology,Phones,725,725,712
AZ-2012-9114156,439,66,3,Furniture,Bookcases,373,373,198
AZ-2012-9114156,25,7,1,Office Supplies,Supplies,18,18,7
AZ-2012-9160965,126,42,3,Technology,Accessories,84,84,126
AZ-2012-9180842,94,27,2,Office Supplies,Supplies,67,67,54
AZ-2012-9208057,1488,372,3,Office Supplies,Appliances,1116,1116,1116
AZ-2012-9208057,24,6,2,Office Supplies,Envelopes,18,18,12
AZ-2012-9208057,99,25,6,Office Supplies,Storage,74,74,150
AZ-2012-9211043,25,11,1,Office Supplies,Paper,14,14,11
AZ-2012-9211043,137,46,1,Technology,Phones,91,91,46
AZ-2012-9215756,372,179,3,Technology,Copiers,193,193,537
AZ-2012-9218935,22,6,2,Furniture,Furnishings,16,16,12
AZ-2012-9218935,1241,87,4,Office Supplies,Appliances,1154,1154,348
AZ-2012-9218935,5785,405,9,Technology,Phones,5380,5380,3645
AZ-2012-9222896,201,98,4,Furniture,Furnishings,103,103,392
AZ-2012-9231454,49,5,1,Office Supplies,Binders,44,44,5
AZ-2012-9237127,146,63,3,Office Supplies,Art,83,83,189
AZ-2012-9241286,340,30,5,Technology,Phones,310,310,150
AZ-2012-925819,43,-1,3,Office Supplies,Binders,44,44,-3
AZ-2012-925819,43,11,3,Office Supplies,Fasteners,32,32,33
AZ-2012-925819,1677,522,6,Technology,Machines,1155,1155,3132
AZ-2012-925819,3442,38,6,Technology,Phones,3404,3404,228
AZ-2012-9266108,61,21,2,Office Supplies,Art,40,40,42
AZ-2012-9269920,293,92,6,Furniture,Furnishings,97,201,552
AZ-2012-9269920,13,5,2,Office Supplies,Binders,8,8,10
AZ-2012-9269920,49,8,1,Office Supplies,Storage,41,41,8
AZ-2012-9269920,43,3,2,Office Supplies,Supplies,40,40,6
AZ-2012-9291301,45,16,3,Office Supplies,Art,29,29,48
AZ-2012-9295804,350,105,2,Furniture,Bookcases,245,245,210
AZ-2012-9295804,54,12,6,Office Supplies,Binders,42,42,72
AZ-2012-9295804,57,27,2,Office Supplies,Paper,30,30,54
AZ-2012-9304844,146,67,11,Office Supplies,Binders,79,79,737
AZ-2012-9304844,130,34,4,Office Supplies,Paper,96,96,136
AZ-2012-9314178,15,7,2,Office Supplies,Binders,8,8,14
AZ-2012-9340970,152,17,3,Office Supplies,Binders,135,135,51
AZ-2012-9364026,62,11,7,Office Supplies,Binders,51,51,77
AZ-2012-9364026,50,2,3,Office Supplies,Supplies,48,48,6
AZ-2012-9382192,142,-46,5,Furniture,Furnishings,188,188,-230
AZ-2012-9385706,44,18,1,Technology,Accessories,26,26,18
AZ-2012-9385706,1909,57,3,Technology,Phones,1852,1852,171
AZ-2012-9394311,408,169,6,Office Supplies,Appliances,102,239,1014
AZ-2012-9396037,13,5,1,Office Supplies,Labels,8,8,5
AZ-2012-9411069,57,1,4,Office Supplies,Art,56,56,4
AZ-2012-9411069,102,30,2,Office Supplies,Binders,72,72,60
AZ-2012-9411069,25,10,3,Office Supplies,Labels,15,15,30
AZ-2012-9411069,916,147,6,Office Supplies,Storage,374,769,882
AZ-2012-9427035,198,99,10,Office Supplies,Fasteners,99,99,990
AZ-2012-943322,74,29,3,Office Supplies,Art,45,45,87
AZ-2012-9453588,22,9,3,Office Supplies,Binders,5,13,27
AZ-2012-9453588,842,11,11,Office Supplies,Storage,63,831,121
AZ-2012-9482146,384,-43,6,Office Supplies,Appliances,427,427,-258
AZ-2012-9482146,287,112,7,Office Supplies,Envelopes,175,175,784
AZ-2012-9482146,1014,125,8,Technology,Phones,464,889,1000
AZ-2012-9487652,1163,12,3,Furniture,Bookcases,1151,1151,36
AZ-2012-9487652,2080,562,4,Office Supplies,Appliances,1518,1518,2248
AZ-2012-9487652,85,0,3,Office Supplies,Binders,85,85,0
AZ-2012-9487652,571,-19,3,Office Supplies,Storage,590,590,-57
AZ-2012-9487652,670,90,5,Technology,Phones,124,580,450
AZ-2012-9488073,365,65,7,Office Supplies,Storage,300,300,455
AZ-2012-9490476,985,142,3,Furniture,Bookcases,843,843,426
AZ-2012-9492180,469,173,7,Office Supplies,Appliances,296,296,1211
AZ-2012-9501435,342,141,5,Technology,Phones,201,201,705
AZ-2012-9503430,827,156,2,Furniture,Chairs,671,671,312
AZ-2012-9503430,24,2,3,Office Supplies,Binders,22,22,6
AZ-2012-9503430,103,1,3,Technology,Accessories,102,102,3
AZ-2012-951643,57,17,2,Office Supplies,Binders,40,40,34
AZ-2012-951643,717,253,5,Technology,Copiers,464,464,1265
AZ-2012-9538044,349,143,2,Technology,Copiers,206,206,286
AZ-2012-9551282,211,10,8,Office Supplies,Art,162,201,80
AZ-2012-9551282,519,73,5,Technology,Accessories,446,446,365
AZ-2012-9553455,30,15,3,Office Supplies,Art,15,15,45
AZ-2012-9553455,497,-28,4,Technology,Phones,525,525,-112
AZ-2012-9568691,534,60,10,Office Supplies,Art,346,474,600
AZ-2012-9568691,1225,-130,4,Technology,Copiers,1355,1355,-520
AZ-2012-957579,2716,796,11,Furniture,Bookcases,1217,1920,8756
AZ-2012-957579,1420,631,3,Office Supplies,Appliances,789,789,1893
AZ-2012-957579,99,33,2,Office Supplies,Art,66,66,66
AZ-2012-957579,99,10,2,Office Supplies,Envelopes,89,89,20
AZ-2012-957579,512,205,2,Technology,Accessories,307,307,410
AZ-2012-957579,2784,273,9,Technology,Phones,728,2511,2457
AZ-2012-958413,66,21,5,Office Supplies,Art,45,45,105
AZ-2012-9588828,98,39,5,Office Supplies,Fasteners,59,59,195
AZ-2012-9588828,30,5,3,Office Supplies,Storage,25,25,15
AZ-2012-9601062,34,13,2,Office Supplies,Fasteners,21,21,26
AZ-2012-9601062,94,21,3,Office Supplies,Paper,73,73,63
AZ-2012-9601062,103,46,2,Office Supplies,Storage,57,57,92
AZ-2012-9602843,761,160,2,Technology,Copiers,601,601,320
AZ-2012-9607544,23,4,1,Office Supplies,Art,19,19,4
AZ-2012-9607544,38,19,3,Office Supplies,Labels,19,19,57
AZ-2012-9607544,805,79,16,Office Supplies,Storage,466,726,1264
AZ-2012-9607544,668,-31,3,Technology,Copiers,699,699,-93
AZ-2012-9607544,284,100,2,Technology,Machines,184,184,200
AZ-2012-9614824,52,18,2,Office Supplies,Art,34,34,36
AZ-2012-9615606,65,30,8,Office Supplies,Binders,35,35,240
AZ-2012-9615606,13,6,2,Office Supplies,Labels,7,7,12
AZ-2012-9615628,49,0,6,Office Supplies,Fasteners,49,49,0
AZ-2012-962050,100,11,2,Furniture,Chairs,89,89,22
AZ-2012-962050,88,16,4,Office Supplies,Art,72,72,64
AZ-2012-962050,113,26,4,Office Supplies,Binders,80,87,104
AZ-2012-962050,248,25,5,Office Supplies,Storage,223,223,125
AZ-2012-9624390,333,73,7,Furniture,Chairs,260,260,511
AZ-2012-9624390,2199,923,7,Technology,Machines,1276,1276,6461
AZ-2012-9627965,48,6,1,Office Supplies,Binders,42,42,6
AZ-2012-9627965,131,32,3,Office Supplies,Storage,99,99,96
AZ-2012-9636405,238,3,2,Furniture,Chairs,235,235,6
AZ-2012-9649659,144,26,3,Office Supplies,Storage,118,118,78
AZ-2012-9662305,212,15,6,Office Supplies,Supplies,197,197,90
AZ-2012-9667148,88,4,3,Office Supplies,Art,84,84,12
AZ-2012-9667148,14,5,2,Office Supplies,Labels,9,9,10
AZ-2012-9667148,407,-195,5,Office Supplies,Storage,249,602,-975
AZ-2012-9667148,505,83,9,Technology,Accessories,186,422,747
AZ-2012-9667148,1166,58,8,Technology,Copiers,1108,1108,464
AZ-2012-9667872,84,28,3,Office Supplies,Binders,56,56,84
AZ-2012-9669717,184,39,13,Office Supplies,Binders,145,145,507
AZ-2012-9672099,12,4,2,Office Supplies,Binders,8,8,8
AZ-2012-9695675,50,6,4,Office Supplies,Binders,44,44,24
AZ-2012-9695675,6,0,1,Office Supplies,Labels,6,6,0
AZ-2012-9695675,903,-43,3,Technology,Copiers,946,946,-129
AZ-2012-9695680,60,24,4,Office Supplies,Fasteners,36,36,96
AZ-2012-9703456,94,21,3,Office Supplies,Paper,73,73,63
AZ-2012-9703456,358,72,2,Office Supplies,Storage,286,286,144
AZ-2012-9714156,232,60,5,Office Supplies,Art,172,172,300
AZ-2012-9721463,169,42,3,Office Supplies,Storage,127,127,126
AZ-2012-9749858,18,3,2,Office Supplies,Binders,15,15,6
AZ-2012-9763714,822,353,2,Furniture,Bookcases,469,469,706
AZ-2012-9764957,269,84,2,Furniture,Bookcases,185,185,168
AZ-2012-9764957,344,23,4,Furniture,Chairs,321,321,92
AZ-2012-9764957,104,3,2,Office Supplies,Art,101,101,6
AZ-2012-9764957,75,26,5,Office Supplies,Fasteners,17,49,130
AZ-2012-9764957,171,6,4,Office Supplies,Storage,165,165,24
AZ-2012-9799805,2769,28,6,Furniture,Chairs,2741,2741,168
AZ-2012-9799805,2146,365,4,Office Supplies,Appliances,1781,1781,1460
AZ-2012-9800130,956,124,4,Technology,Copiers,832,832,496
AZ-2012-9805086,39,16,5,Office Supplies,Binders,23,23,80
AZ-2012-9817190,59,15,3,Office Supplies,Art,14,44,45
AZ-2012-9817190,21,3,2,Office Supplies,Labels,18,18,6
AZ-2012-9817190,83,18,3,Office Supplies,Paper,65,65,54
AZ-2012-9817190,426,4,5,Technology,Machines,422,422,20
AZ-2012-9818400,16,0,2,Office Supplies,Binders,16,16,0
AZ-2012-9818400,141,31,3,Office Supplies,Envelopes,110,110,93
AZ-2012-9819217,34,12,2,Office Supplies,Fasteners,22,22,24
AZ-2012-982062,68,26,4,Office Supplies,Paper,42,42,104
AZ-2012-982062,98,29,2,Office Supplies,Storage,69,69,58
AZ-2012-9824792,1138,364,2,Office Supplies,Appliances,774,774,728
AZ-2012-9824792,370,81,8,Office Supplies,Supplies,289,289,648
AZ-2012-9827676,49,5,4,Office Supplies,Binders,44,44,20
AZ-2012-9827676,26,11,2,Office Supplies,Labels,15,15,22
AZ-2012-9827676,964,337,3,Technology,Copiers,627,627,1011
AZ-2012-9836738,239,0,9,Office Supplies,Paper,239,239,0
AZ-2012-9858311,190,95,7,Office Supplies,Art,95,95,665
AZ-2012-9858311,597,6,7,Technology,Machines,591,591,42
AZ-2012-9860400,263,47,2,Furniture,Chairs,216,216,94
AZ-2012-9860400,403,181,14,Office Supplies,Binders,222,222,2534
AZ-2012-9860400,716,250,6,Technology,Machines,466,466,1500
AZ-2012-9884785,230,21,6,Office Supplies,Envelopes,209,209,126
AZ-2012-9886998,1167,93,3,Furniture,Bookcases,1074,1074,279
AZ-2012-9886998,96,18,4,Office Supplies,Art,78,78,72
AZ-2012-9921309,948,126,13,Technology,Phones,822,822,1638
AZ-2012-9926323,94,34,2,Furniture,Furnishings,60,60,68
AZ-2012-9926323,1560,421,3,Office Supplies,Appliances,1139,1139,1263
AZ-2012-9926323,37,16,4,Office Supplies,Binders,21,21,64
AZ-2012-9926323,36,12,1,Office Supplies,Supplies,24,24,12
AZ-2012-9944361,114,26,10,Office Supplies,Art,88,88,260
AZ-2012-9944361,40,18,3,Office Supplies,Binders,22,22,54
AZ-2012-9944361,50,16,3,Office Supplies,Fasteners,34,34,48
AZ-2012-9961341,43,2,3,Office Supplies,Binders,41,41,6
AZ-2012-9982238,73,12,5,Office Supplies,Fasteners,61,61,60
AZ-2012-9982238,360,30,3,Technology,Copiers,330,330,90
AZ-2012-9985308,63,8,3,Office Supplies,Storage,55,55,24
AZ-2012-998550,498,56,5,Furniture,Bookcases,442,442,280
AZ-2013-1014615,47,8,4,Office Supplies,Fasteners,20,39,32
AZ-2013-1025501,231,46,2,Office Supplies,Storage,185,185,92
AZ-2013-1032687,54,8,6,Office Supplies,Labels,46,46,48
AZ-2013-1036545,881,335,2,Furniture,Bookcases,546,546,670
AZ-2013-1043489,307,-31,6,Office Supplies,Art,338,338,-186
AZ-2013-1043489,77,27,3,Office Supplies,Paper,50,50,81
AZ-2013-1043489,364,-32,4,Technology,Accessories,396,396,-128
AZ-2013-1059727,36,10,2,Office Supplies,Paper,26,26,20
AZ-2013-1069052,121,55,12,Office Supplies,Binders,66,66,660
AZ-2013-1069052,59,24,2,Office Supplies,Supplies,35,35,48
AZ-2013-1069052,136,29,2,Technology,Phones,107,107,58
AZ-2013-1085752,24,10,2,Office Supplies,Art,14,14,20
AZ-2013-1085752,75,-40,2,Office Supplies,Storage,115,115,-80
AZ-2013-1085752,739,281,3,Technology,Accessories,458,458,843
AZ-2013-1120035,980,283,3,Furniture,Bookcases,697,697,849
AZ-2013-1120520,357,155,2,Office Supplies,Storage,202,202,310
AZ-2013-112796,434,161,4,Furniture,Furnishings,273,273,644
AZ-2013-112796,342,62,7,Office Supplies,Art,103,280,434
AZ-2013-1146430,178,45,4,Office Supplies,Art,133,133,180
AZ-2013-1146430,1208,274,10,Technology,Machines,785,934,2740
AZ-2013-1150864,437,183,6,Technology,Accessories,254,254,1098
AZ-2013-1179827,827,-92,2,Furniture,Chairs,919,919,-184
AZ-2013-1179827,229,51,3,Office Supplies,Appliances,178,178,153
AZ-2013-1179827,17,7,1,Office Supplies,Storage,10,10,7
AZ-2013-1201319,133,44,3,Office Supplies,Art,89,89,132
AZ-2013-1201319,296,50,10,Office Supplies,Binders,246,246,500
AZ-2013-1201319,464,28,3,Technology,Phones,436,436,84
AZ-2013-1203814,437,29,3,Technology,Machines,408,408,87
AZ-2013-1211955,42,16,3,Office Supplies,Fasteners,26,26,48
AZ-2013-1229971,154,14,3,Office Supplies,Binders,140,140,42
AZ-2013-1235765,488,244,6,Technology,Accessories,244,244,1464
AZ-2013-1244068,207,35,4,Office Supplies,Art,172,172,140
AZ-2013-1244068,241,46,8,Office Supplies,Binders,195,195,368
AZ-2013-1244068,114,21,4,Technology,Accessories,93,93,84
AZ-2013-1245040,58,8,2,Office Supplies,Art,50,50,16
AZ-2013-125479,264,50,3,Furniture,Chairs,214,214,150
AZ-2013-125479,18,1,1,Furniture,Furnishings,17,17,1
AZ-2013-125479,43,0,2,Office Supplies,Envelopes,43,43,0
AZ-2013-1255477,524,81,3,Furniture,Bookcases,443,443,243
AZ-2013-1271613,101,38,2,Furniture,Furnishings,63,63,76
AZ-2013-1271613,147,65,6,Office Supplies,Envelopes,82,82,390
AZ-2013-1271613,222,-100,2,Technology,Phones,322,322,-200
AZ-2013-1274934,11,3,1,Furniture,Furnishings,8,8,3
AZ-2013-1278539,140,66,3,Office Supplies,Art,74,74,198
AZ-2013-1283973,50,3,1,Office Supplies,Binders,47,47,3
AZ-2013-1283973,32,5,3,Office Supplies,Labels,27,27,15
AZ-2013-1288861,487,52,3,Technology,Copiers,435,435,156
AZ-2013-1301183,180,50,2,Furniture,Chairs,130,130,100
AZ-2013-1301183,71,-1,3,Office Supplies,Art,72,72,-3
AZ-2013-1305763,82,24,6,Office Supplies,Binders,58,58,144
AZ-2013-1305763,112,46,4,Office Supplies,Supplies,66,66,184
AZ-2013-1305763,718,316,3,Technology,Copiers,402,402,948
AZ-2013-1307141,313,27,4,Furniture,Chairs,286,286,108
AZ-2013-1307141,135,34,3,Office Supplies,Art,101,101,102
AZ-2013-1307141,215,50,2,Technology,Machines,165,165,100
AZ-2013-1311863,74,33,6,Office Supplies,Binders,41,41,198
AZ-2013-1311863,167,37,3,Office Supplies,Storage,130,130,111
AZ-2013-1311863,428,10,3,Technology,Phones,418,418,30
AZ-2013-1313420,1306,107,6,Technology,Machines,1199,1199,642
AZ-2013-1317735,1707,341,9,Technology,Copiers,1366,1366,3069
AZ-2013-1321075,215,88,3,Technology,Machines,127,127,264
AZ-2013-135124,18,9,2,Office Supplies,Labels,9,9,18
AZ-2013-1362722,287,103,2,Furniture,Chairs,184,184,206
AZ-2013-1362722,599,0,2,Technology,Copiers,599,599,0
AZ-2013-1368588,1327,221,7,Office Supplies,Storage,1106,1106,1547
AZ-2013-1368588,796,47,3,Technology,Machines,749,749,141
AZ-2013-1372468,84,41,3,Office Supplies,Paper,43,43,123
AZ-2013-1376512,158,69,3,Office Supplies,Art,89,89,207
AZ-2013-1380868,135,68,5,Office Supplies,Art,67,67,340
AZ-2013-1388656,34,8,3,Office Supplies,Labels,26,26,24
AZ-2013-1389510,117,6,4,Office Supplies,Art,111,111,24
AZ-2013-1408349,31,7,1,Office Supplies,Paper,24,24,7
AZ-2013-1408349,600,240,2,Technology,Copiers,360,360,480
AZ-2013-1414174,3156,35,7,Office Supplies,Appliances,3121,3121,245
AZ-2013-1414174,38,19,2,Office Supplies,Fasteners,19,19,38
AZ-2013-1437860,1339,223,3,Office Supplies,Appliances,1116,1116,669
AZ-2013-1444287,21,1,2,Office Supplies,Fasteners,20,20,2
AZ-2013-1444287,325,65,9,Technology,Accessories,260,260,585
AZ-2013-1448601,32,2,3,Office Supplies,Labels,30,30,6
AZ-2013-1450841,93,38,7,Office Supplies,Binders,55,55,266
AZ-2013-1483452,2147,580,7,Office Supplies,Appliances,1567,1567,4060
AZ-2013-1509081,43,11,4,Office Supplies,Binders,32,32,44
AZ-2013-1510568,245,122,5,Office Supplies,Art,123,123,610
AZ-2013-1527554,87,25,3,Office Supplies,Binders,62,62,75
AZ-2013-156529,303,33,6,Office Supplies,Binders,270,270,198
AZ-2013-156529,1829,567,9,Office Supplies,Storage,1262,1262,5103
AZ-2013-156529,215,52,5,Office Supplies,Supplies,163,163,260
AZ-2013-1568579,51,20,3,Office Supplies,Storage,31,31,60
AZ-2013-1568579,1536,171,9,Technology,Copiers,1365,1365,1539
AZ-2013-1571191,2478,1041,5,Office Supplies,Appliances,1437,1437,5205
AZ-2013-1571444,27,12,3,Office Supplies,Labels,15,15,36
AZ-2013-1571444,30,5,2,Office Supplies,Paper,25,25,10
AZ-2013-1579210,193,62,6,Office Supplies,Supplies,131,131,372
AZ-2013-1611944,325,75,6,Office Supplies,Appliances,250,250,450
AZ-2013-1611944,62,29,3,Office Supplies,Paper,33,33,87
AZ-2013-162732,175,10,3,Furniture,Furnishings,165,165,30
AZ-2013-162732,83,7,3,Office Supplies,Art,76,76,21
AZ-2013-162732,343,154,7,Office Supplies,Storage,189,189,1078
AZ-2013-1639148,26,7,1,Office Supplies,Art,19,19,7
AZ-2013-1639148,54,21,5,Office Supplies,Labels,33,33,105
AZ-2013-1651080,88,16,4,Office Supplies,Art,72,72,64
AZ-2013-1651080,57,21,5,Office Supplies,Binders,36,36,105
AZ-2013-1651080,344,62,13,Office Supplies,Paper,282,282,806
AZ-2013-1668042,567,28,1,Office Supplies,Appliances,539,539,28
AZ-2013-1668042,140,6,5,Office Supplies,Art,134,134,30
AZ-2013-1668042,44,15,4,Office Supplies,Fasteners,29,29,60
AZ-2013-1673831,143,70,3,Office Supplies,Envelopes,73,73,210
AZ-2013-1673831,34,15,3,Office Supplies,Fasteners,19,19,45
AZ-2013-1683748,183,84,4,Office Supplies,Art,99,99,336
AZ-2013-1683748,155,-5,3,Office Supplies,Storage,160,160,-15
AZ-2013-1683748,228,114,2,Technology,Machines,114,114,228
AZ-2013-1690720,331,27,3,Technology,Phones,304,304,81
AZ-2013-1699821,73,3,5,Office Supplies,Binders,70,70,15
AZ-2013-1699821,80,4,2,Office Supplies,Envelopes,76,76,8
AZ-2013-1703913,810,24,5,Furniture,Chairs,786,786,120
AZ-2013-1703913,34,14,6,Office Supplies,Binders,20,20,84
AZ-2013-1703913,572,34,7,Technology,Accessories,538,538,238
AZ-2013-1725990,22,4,1,Office Supplies,Art,18,18,4
AZ-2013-1725990,177,21,6,Office Supplies,Supplies,156,156,126
AZ-2013-1738409,147,72,5,Office Supplies,Envelopes,75,75,360
AZ-2013-1741876,745,27,5,Furniture,Bookcases,558,718,135
AZ-2013-1777709,57,3,2,Office Supplies,Paper,54,54,6
AZ-2013-1781904,88,32,2,Office Supplies,Supplies,56,56,64
AZ-2013-183270,58,8,2,Office Supplies,Art,50,50,16
AZ-2013-183270,33,1,2,Office Supplies,Paper,32,32,2
AZ-2013-186027,51,20,3,Office Supplies,Storage,31,31,60
AZ-2013-1894900,90,45,2,Office Supplies,Paper,45,45,90
AZ-2013-1900588,194,52,4,Office Supplies,Storage,142,142,208
AZ-2013-1907055,198,32,4,Office Supplies,Art,166,166,128
AZ-2013-1907055,356,7,6,Technology,Accessories,349,349,42
AZ-2013-1917714,24,8,1,Office Supplies,Storage,16,16,8
AZ-2013-1917836,27,6,3,Office Supplies,Binders,21,21,18
AZ-2013-1921214,423,173,3,Furniture,Chairs,250,250,519
AZ-2013-1947609,29,8,5,Office Supplies,Binders,21,21,40
AZ-2013-1958192,76,25,3,Office Supplies,Art,51,51,75
AZ-2013-1978378,103,50,2,Furniture,Furnishings,53,53,100
AZ-2013-1998308,63,28,4,Office Supplies,Envelopes,35,35,112
AZ-2013-200984,267,88,6,Office Supplies,Art,179,179,528
AZ-2013-200984,13,3,3,Office Supplies,Labels,10,10,9
AZ-2013-200984,328,82,6,Office Supplies,Storage,246,246,492
AZ-2013-2010603,339,95,6,Furniture,Furnishings,244,244,570
AZ-2013-2010603,55,26,1,Office Supplies,Art,29,29,26
AZ-2013-2010603,141,0,5,Office Supplies,Binders,141,141,0
AZ-2013-2010603,242,100,2,Office Supplies,Storage,142,142,200
AZ-2013-2010603,194,14,3,Technology,Phones,180,180,42
AZ-2013-2011529,156,53,9,Office Supplies,Binders,11,103,477
AZ-2013-2011529,88,22,2,Office Supplies,Storage,66,66,44
AZ-2013-2014135,49,24,3,Office Supplies,Fasteners,25,25,72
AZ-2013-2015802,102,14,5,Office Supplies,Paper,88,88,70
AZ-2013-2020686,194,15,7,Office Supplies,Art,179,179,105
AZ-2013-2036266,22,9,2,Office Supplies,Fasteners,13,13,18
AZ-2013-2039163,127,28,6,Office Supplies,Binders,77,99,168
AZ-2013-2039163,101,48,5,Office Supplies,Envelopes,53,53,240
AZ-2013-2039163,389,99,9,Office Supplies,Storage,290,290,891
AZ-2013-2047593,289,63,5,Furniture,Chairs,226,226,315
AZ-2013-2047593,11,3,1,Office Supplies,Fasteners,8,8,3
AZ-2013-2055109,67,16,6,Office Supplies,Art,51,51,96
AZ-2013-2070413,54,11,3,Office Supplies,Paper,43,43,33
AZ-2013-2076679,93,24,2,Office Supplies,Art,69,69,48
AZ-2013-2076679,34,1,1,Office Supplies,Storage,33,33,1
AZ-2013-2101736,158,69,3,Office Supplies,Art,89,89,207
AZ-2013-2111438,1243,398,3,Furniture,Bookcases,845,845,1194
AZ-2013-212873,226,72,7,Office Supplies,Supplies,154,154,504
AZ-2013-2133544,299,95,11,Office Supplies,Art,160,204,1045
AZ-2013-2134224,152,47,1,Furniture,Bookcases,105,105,47
AZ-2013-2134224,124,8,7,Office Supplies,Storage,116,116,56
AZ-2013-214394,366,85,2,Office Supplies,Storage,281,281,170
AZ-2013-215072,132,48,3,Furniture,Furnishings,84,84,144
AZ-2013-2156489,741,104,6,Furniture,Bookcases,637,637,624
AZ-2013-2156489,51,23,1,Office Supplies,Binders,28,28,23
AZ-2013-2162225,79,39,3,Office Supplies,Envelopes,40,40,117
AZ-2013-2169586,1085,11,3,Technology,Copiers,1074,1074,33
AZ-2013-2176321,46,0,3,Office Supplies,Paper,46,46,0
AZ-2013-2182228,27,9,2,Office Supplies,Binders,18,18,18
AZ-2013-2182228,31,2,2,Office Supplies,Supplies,29,29,4
AZ-2013-2183455,125,6,5,Office Supplies,Envelopes,119,119,30
AZ-2013-2183455,19,9,3,Office Supplies,Labels,10,10,27
AZ-2013-2183455,862,198,5,Technology,Machines,664,664,990
AZ-2013-2184439,302,121,7,Office Supplies,Storage,181,181,847
AZ-2013-2185600,2070,186,7,Technology,Copiers,1884,1884,1302
AZ-2013-2192067,309,82,2,Furniture,Chairs,227,227,164
AZ-2013-219349,250,120,3,Technology,Accessories,130,130,360
AZ-2013-2203861,289,116,2,Technology,Copiers,173,173,232
AZ-2013-2204444,20,2,2,Office Supplies,Storage,18,18,4
AZ-2013-2208942,45,23,1,Office Supplies,Paper,22,22,23
AZ-2013-2208942,621,236,2,Technology,Machines,385,385,472
AZ-2013-2243804,84,10,4,Office Supplies,Storage,74,74,40
AZ-2013-2248449,1689,274,10,Furniture,Bookcases,701,1415,2740
AZ-2013-2248449,60,14,2,Office Supplies,Art,46,46,28
AZ-2013-2248449,91,42,3,Office Supplies,Binders,49,49,126
AZ-2013-2254265,33,5,2,Office Supplies,Art,28,28,10
AZ-2013-2259451,85,38,3,Technology,Accessories,47,47,114
AZ-2013-2266465,23,6,2,Office Supplies,Binders,17,17,12
AZ-2013-2267940,40,-31,3,Office Supplies,Envelopes,71,71,-93
AZ-2013-2275252,57,6,4,Office Supplies,Art,51,51,24
AZ-2013-2276631,30,15,3,Office Supplies,Art,15,15,45
AZ-2013-2276631,15,6,1,Office Supplies,Fasteners,9,9,6
AZ-2013-2276631,21,6,2,Office Supplies,Labels,15,15,12
AZ-2013-2276631,276,46,8,Office Supplies,Storage,230,230,368
AZ-2013-2276631,146,-83,2,Technology,Machines,229,229,-166
AZ-2013-2294363,41,16,1,Office Supplies,Envelopes,25,25,16
AZ-2013-2300894,36,5,1,Office Supplies,Envelopes,31,31,5
AZ-2013-2312887,126,6,5,Furniture,Furnishings,120,120,30
AZ-2013-2312887,145,59,5,Office Supplies,Art,86,86,295
AZ-2013-2312887,28,13,3,Office Supplies,Labels,15,15,39
AZ-2013-2312887,41,1,2,Office Supplies,Storage,40,40,2
AZ-2013-2312887,42,14,1,Technology,Accessories,28,28,14
AZ-2013-2326728,304,95,2,Furniture,Bookcases,209,209,190
AZ-2013-2341565,781,165,5,Technology,Phones,616,616,825
AZ-2013-2343353,382,92,2,Technology,Copiers,290,290,184
AZ-2013-2353394,38,14,2,Furniture,Furnishings,24,24,28
AZ-2013-2357064,1498,0,5,Technology,Copiers,1498,1498,0
AZ-2013-2377815,116,52,1,Furniture,Furnishings,64,64,52
AZ-2013-2380207,124,38,4,Office Supplies,Envelopes,86,86,152
AZ-2013-2429126,1232,278,8,Technology,Machines,422,954,2224
AZ-2013-242926,141,41,3,Office Supplies,Paper,100,100,123
AZ-2013-2435925,39,18,2,Office Supplies,Fasteners,21,21,36
AZ-2013-2436002,46,19,3,Office Supplies,Storage,27,27,57
AZ-2013-2437220,34,12,3,Office Supplies,Binders,22,22,36
AZ-2013-244740,86,-8,4,Office Supplies,Storage,94,94,-32
AZ-2013-244740,1772,0,6,Technology,Copiers,1772,1772,0
AZ-2013-2465655,85,0,3,Office Supplies,Binders,85,85,0
AZ-2013-2468600,287,-172,5,Furniture,Chairs,459,459,-860
AZ-2013-2468600,77,24,7,Office Supplies,Binders,53,53,168
AZ-2013-2468600,30,-7,3,Office Supplies,Storage,37,37,-21
AZ-2013-2474005,25,2,3,Office Supplies,Labels,23,23,6
AZ-2013-2474005,512,205,2,Technology,Accessories,307,307,410
AZ-2013-2482135,233,-33,3,Furniture,Furnishings,266,266,-99
AZ-2013-2482135,256,120,8,Technology,Accessories,136,136,960
AZ-2013-248580,71,1,3,Office Supplies,Art,70,70,3
AZ-2013-248580,1084,166,2,Technology,Phones,918,918,332
AZ-2013-2495842,98,12,2,Office Supplies,Storage,86,86,24
AZ-2013-2506599,92,-28,3,Office Supplies,Appliances,120,120,-84
AZ-2013-2506599,64,-31,6,Office Supplies,Art,23,95,-186
AZ-2013-2506599,51,-15,2,Office Supplies,Binders,66,66,-30
AZ-2013-2506599,50,-38,2,Office Supplies,Paper,88,88,-76
AZ-2013-2520364,110,2,7,Office Supplies,Storage,108,108,14
AZ-2013-2526896,251,40,5,Furniture,Furnishings,211,211,200
AZ-2013-2526896,149,4,5,Office Supplies,Paper,145,145,20
AZ-2013-2526896,269,126,2,Office Supplies,Storage,143,143,252
AZ-2013-2526896,3422,1061,9,Technology,Copiers,2361,2361,9549
AZ-2013-253234,209,2,7,Office Supplies,Envelopes,207,207,14
AZ-2013-2534161,64,32,4,Furniture,Furnishings,32,32,128
AZ-2013-2534161,117,51,2,Office Supplies,Appliances,66,66,102
AZ-2013-2534161,139,58,3,Office Supplies,Envelopes,81,81,174
AZ-2013-2534161,68,11,6,Office Supplies,Labels,57,57,66
AZ-2013-2543728,63,19,3,Office Supplies,Envelopes,44,44,57
AZ-2013-2543728,965,-68,3,Technology,Copiers,1033,1033,-204
AZ-2013-2544170,205,46,4,Office Supplies,Appliances,159,159,184
AZ-2013-2544170,44,8,2,Office Supplies,Art,36,36,16
AZ-2013-2544170,373,66,2,Office Supplies,Storage,307,307,132
AZ-2013-2558341,50,15,2,Furniture,Furnishings,35,35,30
AZ-2013-2558341,146,18,7,Office Supplies,Storage,128,128,126
AZ-2013-2566015,573,126,4,Furniture,Bookcases,447,447,504
AZ-2013-2566015,71,11,5,Office Supplies,Binders,49,60,55
AZ-2013-2566015,122,1,4,Office Supplies,Paper,121,121,4
AZ-2013-2566015,63,8,3,Office Supplies,Storage,55,55,24
AZ-2013-2566015,450,225,4,Technology,Accessories,225,225,900
AZ-2013-2573361,644,89,12,Office Supplies,Art,405,555,1068
AZ-2013-2573361,71,14,5,Office Supplies,Fasteners,57,57,70
AZ-2013-2573361,218,90,5,Office Supplies,Storage,128,128,450
AZ-2013-2582964,52,8,1,Office Supplies,Art,44,44,8
AZ-2013-2587555,119,11,4,Office Supplies,Paper,108,108,44
AZ-2013-2605178,138,46,5,Office Supplies,Binders,32,92,230
AZ-2013-2605178,9,1,1,Office Supplies,Supplies,8,8,1
AZ-2013-2652183,47,-32,5,Office Supplies,Fasteners,79,79,-160
AZ-2013-2652268,41,15,4,Office Supplies,Labels,26,26,60
AZ-2013-2659520,304,97,6,Office Supplies,Art,207,207,582
AZ-2013-2667784,1270,433,5,Technology,Machines,837,837,2165
AZ-2013-267160,463,105,9,Office Supplies,Art,248,358,945
AZ-2013-267160,85,3,3,Technology,Accessories,82,82,9
AZ-2013-267160,628,213,7,Technology,Phones,415,415,1491
AZ-2013-2671803,127,48,6,Office Supplies,Storage,79,79,288
AZ-2013-2671992,135,39,1,Furniture,Bookcases,96,96,39
AZ-2013-2678161,33,9,5,Office Supplies,Binders,24,24,45
AZ-2013-2678161,116,56,5,Office Supplies,Supplies,60,60,280
AZ-2013-2688830,222,22,3,Technology,Accessories,200,200,66
AZ-2013-2690702,232,60,5,Office Supplies,Art,172,172,300
AZ-2013-2709620,76,21,3,Office Supplies,Art,55,55,63
AZ-2013-2709620,347,59,9,Technology,Accessories,288,288,531
AZ-2013-2709879,71,1,5,Office Supplies,Art,70,70,5
AZ-2013-2721224,58,26,2,Office Supplies,Binders,32,32,52
AZ-2013-273412,388,147,4,Office Supplies,Appliances,241,241,588
AZ-2013-273412,4,0,1,Office Supplies,Binders,4,4,0
AZ-2013-273412,89,8,3,Technology,Accessories,81,81,24
AZ-2013-2736729,306,20,2,Furniture,Bookcases,286,286,40
AZ-2013-2736729,32,8,5,Office Supplies,Binders,24,24,40
AZ-2013-2753412,596,101,8,Technology,Phones,495,495,808
AZ-2013-2764499,461,-5,3,Furniture,Bookcases,466,466,-15
AZ-2013-2764499,268,83,4,Furniture,Chairs,185,185,332
AZ-2013-2791278,635,279,3,Office Supplies,Storage,356,356,837
AZ-2013-2791278,167,25,1,Technology,Phones,142,142,25
AZ-2013-2794023,9,-5,2,Office Supplies,Binders,14,14,-10
AZ-2013-2794023,167,-73,2,Technology,Phones,240,240,-146
AZ-2013-281337,569,92,4,Furniture,Chairs,477,477,368
AZ-2013-28182,60,10,2,Office Supplies,Art,50,50,20
AZ-2013-28182,470,125,3,Technology,Machines,345,345,375
AZ-2013-2820920,61,28,2,Office Supplies,Binders,33,33,56
AZ-2013-2820920,77,5,4,Office Supplies,Envelopes,72,72,20
AZ-2013-2847,3063,1470,7,Furniture,Bookcases,1593,1593,10290
AZ-2013-2847,82,36,2,Office Supplies,Appliances,46,46,72
AZ-2013-2847,47,11,5,Office Supplies,Binders,18,36,55
AZ-2013-2847,57,16,5,Office Supplies,Labels,41,41,80
AZ-2013-2848176,1221,417,6,Technology,Copiers,804,804,2502
AZ-2013-2853568,369,149,8,Office Supplies,Art,148,220,1192
AZ-2013-2853568,147,51,5,Office Supplies,Binders,96,96,255
AZ-2013-2853568,642,276,5,Office Supplies,Storage,366,366,1380
AZ-2013-2857120,49,24,3,Office Supplies,Fasteners,25,25,72
AZ-2013-2857120,304,72,3,Technology,Machines,232,232,216
AZ-2013-2868494,46,13,3,Office Supplies,Binders,33,33,39
AZ-2013-2868494,112,55,4,Office Supplies,Paper,57,57,220
AZ-2013-2871668,58,21,8,Office Supplies,Binders,11,37,168
AZ-2013-2890966,2290,560,4,Technology,Phones,1730,1730,2240
AZ-2013-2901079,757,371,2,Technology,Copiers,386,386,742
AZ-2013-2914891,1235,469,3,Furniture,Bookcases,766,766,1407
AZ-2013-2914891,83,20,7,Office Supplies,Envelopes,63,63,140
AZ-2013-2914891,22,9,2,Office Supplies,Fasteners,13,13,18
AZ-2013-2914891,475,-238,4,Office Supplies,Storage,713,713,-952
AZ-2013-2914891,765,-370,2,Technology,Phones,1135,1135,-740
AZ-2013-2927479,387,32,6,Technology,Phones,355,355,192
AZ-2013-2960251,442,24,6,Furniture,Chairs,150,418,144
AZ-2013-2961520,344,148,7,Office Supplies,Binders,196,196,1036
AZ-2013-2963078,201,12,4,Office Supplies,Binders,189,189,48
AZ-2013-2972067,83,7,3,Office Supplies,Art,76,76,21
AZ-2013-2986010,19,8,2,Office Supplies,Binders,11,11,16
AZ-2013-2986010,44,7,1,Office Supplies,Storage,37,37,7
AZ-2013-2986010,335,43,7,Technology,Accessories,292,292,301
AZ-2013-2994768,24,11,3,Office Supplies,Binders,13,13,33
AZ-2013-2994768,155,-5,3,Office Supplies,Storage,160,160,-15
AZ-2013-2994768,1638,730,8,Technology,Accessories,824,908,5840
AZ-2013-2994768,314,37,3,Technology,Phones,277,277,111
AZ-2013-3001151,9,1,1,Office Supplies,Storage,8,8,1
AZ-2013-3010251,2893,-97,5,Technology,Phones,2990,2990,-485
AZ-2013-3020198,126,3,3,Office Supplies,Appliances,123,123,9
AZ-2013-3020198,72,21,7,Office Supplies,Storage,51,51,147
AZ-2013-3021491,222,69,2,Furniture,Bookcases,153,153,138
AZ-2013-3021491,18,8,2,Office Supplies,Labels,10,10,16
AZ-2013-3032452,15,2,1,Office Supplies,Envelopes,13,13,2
AZ-2013-3032452,154,53,3,Office Supplies,Storage,101,101,159
AZ-2013-3075168,947,275,2,Furniture,Chairs,672,672,550
AZ-2013-3075168,102,5,2,Office Supplies,Envelopes,97,97,10
AZ-2013-3075168,396,194,2,Office Supplies,Storage,202,202,388
AZ-2013-3088636,36,3,2,Office Supplies,Art,33,33,6
AZ-2013-308992,278,62,3,Technology,Machines,216,216,186
AZ-2013-3097789,67,20,4,Office Supplies,Paper,47,47,80
AZ-2013-3097789,366,44,5,Technology,Phones,322,322,220
AZ-2013-3127336,322,148,8,Office Supplies,Art,147,174,1184
AZ-2013-3127336,31,6,3,Office Supplies,Fasteners,25,25,18
AZ-2013-3127336,14,4,3,Office Supplies,Labels,10,10,12
AZ-2013-3127336,219,42,7,Office Supplies,Paper,53,177,294
AZ-2013-3127336,383,166,7,Office Supplies,Storage,217,217,1162
AZ-2013-3127336,37,13,1,Office Supplies,Supplies,24,24,13
AZ-2013-3127336,1509,45,5,Technology,Machines,1464,1464,225
AZ-2013-3136343,31,6,3,Office Supplies,Labels,25,25,18
AZ-2013-3142223,147,21,3,Furniture,Furnishings,126,126,63
AZ-2013-3145442,143,3,1,Technology,Copiers,140,140,3
AZ-2013-3148222,32,4,3,Office Supplies,Envelopes,28,28,12
AZ-2013-3148222,36,1,3,Office Supplies,Fasteners,35,35,3
AZ-2013-3148222,111,-3,4,Office Supplies,Storage,114,114,-12
AZ-2013-3156209,231,46,3,Furniture,Furnishings,185,185,138
AZ-2013-3156209,127,34,5,Office Supplies,Art,93,93,170
AZ-2013-3156209,12,0,2,Office Supplies,Binders,12,12,0
AZ-2013-3156209,104,43,5,Office Supplies,Paper,61,61,215
AZ-2013-3160471,56,20,4,Office Supplies,Fasteners,36,36,80
AZ-2013-3174742,107,9,4,Office Supplies,Art,98,98,36
AZ-2013-3198739,360,22,3,Technology,Copiers,338,338,66
AZ-2013-3198739,436,164,4,Technology,Machines,272,272,656
AZ-2013-3213150,56,14,5,Office Supplies,Labels,42,42,70
AZ-2013-3220222,49,22,2,Office Supplies,Envelopes,27,27,44
AZ-2013-3224122,920,-575,5,Furniture,Chairs,1495,1495,-2875
AZ-2013-3224122,320,-77,2,Furniture,Tables,397,397,-154
AZ-2013-3224122,486,209,10,Office Supplies,Art,277,277,2090
AZ-2013-3224122,165,59,9,Office Supplies,Paper,106,106,531
AZ-2013-3225863,508,208,3,Furniture,Bookcases,300,300,624
AZ-2013-3232333,98,44,2,Furniture,Furnishings,54,54,88
AZ-2013-3240279,154,14,1,Furniture,Bookcases,140,140,14
AZ-2013-3256885,12,4,2,Office Supplies,Binders,8,8,8
AZ-2013-327406,1726,-478,5,Furniture,Tables,2204,2204,-2390
AZ-2013-327406,154,29,3,Office Supplies,Art,125,125,87
AZ-2013-327406,61,28,2,Office Supplies,Binders,33,33,56
AZ-2013-327406,2477,367,8,Technology,Copiers,439,2110,2936
AZ-2013-3274770,51,14,2,Office Supplies,Art,37,37,28
AZ-2013-3293484,353,7,7,Office Supplies,Binders,346,346,49
AZ-2013-3298349,128,34,6,Office Supplies,Binders,34,94,204
AZ-2013-3301955,143,11,8,Office Supplies,Art,132,132,88
AZ-2013-3301955,118,13,2,Technology,Accessories,105,105,26
AZ-2013-3314064,64,32,2,Office Supplies,Art,32,32,64
AZ-2013-3326917,75,9,3,Office Supplies,Supplies,66,66,27
AZ-2013-3328876,1028,297,2,Office Supplies,Appliances,731,731,594
AZ-2013-3352012,428,176,4,Furniture,Furnishings,252,252,704
AZ-2013-3352012,29,10,2,Office Supplies,Art,19,19,20
AZ-2013-3352012,34,1,2,Office Supplies,Binders,33,33,2
AZ-2013-3352012,240,43,5,Office Supplies,Storage,197,197,215
AZ-2013-3352012,298,24,4,Technology,Machines,274,274,96
AZ-2013-3357605,42,0,5,Office Supplies,Labels,42,42,0
AZ-2013-3364544,13,5,1,Office Supplies,Fasteners,8,8,5
AZ-2013-3367178,370,33,14,Office Supplies,Art,337,337,462
AZ-2013-3387744,110,16,3,Office Supplies,Supplies,94,94,48
AZ-2013-3395189,119,53,5,Office Supplies,Paper,66,66,265
AZ-2013-3395189,891,0,5,Office Supplies,Storage,891,891,0
AZ-2013-3395189,656,50,4,Technology,Copiers,293,606,200
AZ-2013-3430567,85,31,6,Office Supplies,Fasteners,54,54,186
AZ-2013-3430567,66,18,5,Office Supplies,Supplies,48,48,90
AZ-2013-343563,48,13,3,Office Supplies,Fasteners,35,35,39
AZ-2013-3461507,85,-9,4,Office Supplies,Storage,94,94,-36
AZ-2013-3461507,355,63,3,Technology,Phones,292,292,189
AZ-2013-3483064,60,22,4,Office Supplies,Art,38,38,88
AZ-2013-3483064,710,-65,4,Technology,Machines,274,775,-260
AZ-2013-3483098,278,58,4,Furniture,Chairs,220,220,232
AZ-2013-3483098,74,32,3,Office Supplies,Envelopes,42,42,96
AZ-2013-3483098,153,5,1,Technology,Phones,148,148,5
AZ-2013-3485300,33,6,3,Office Supplies,Labels,27,27,18
AZ-2013-3515290,394,146,2,Furniture,Bookcases,248,248,292
AZ-2013-3515290,292,137,6,Office Supplies,Art,155,155,822
AZ-2013-351604,3802,1445,7,Office Supplies,Appliances,2357,2357,10115
AZ-2013-351604,73,13,4,Office Supplies,Envelopes,60,60,52
AZ-2013-351604,333,17,8,Office Supplies,Supplies,316,316,136
AZ-2013-3557634,398,60,7,Office Supplies,Art,338,338,420
AZ-2013-3564823,2757,1164,7,Furniture,Bookcases,1593,1593,8148
AZ-2013-3564823,40,18,2,Office Supplies,Supplies,22,22,36
AZ-2013-3569377,79,32,3,Office Supplies,Art,47,47,96
AZ-2013-3569377,14,6,3,Office Supplies,Binders,8,8,18
AZ-2013-3569377,1607,125,9,Office Supplies,Storage,1482,1482,1125
AZ-2013-3569377,171,29,3,Technology,Accessories,142,142,87
AZ-2013-360970,70,22,8,Office Supplies,Labels,48,48,176
AZ-2013-3615405,22,4,1,Office Supplies,Art,18,18,4
AZ-2013-3615405,17,7,3,Office Supplies,Binders,10,10,21
AZ-2013-3620842,644,167,2,Technology,Copiers,477,477,334
AZ-2013-3623970,31,13,2,Office Supplies,Storage,18,18,26
AZ-2013-3623970,260,39,7,Technology,Machines,221,221,273
AZ-2013-3627184,61,19,3,Office Supplies,Paper,42,42,57
AZ-2013-3656949,40,10,7,Office Supplies,Binders,18,30,70
AZ-2013-3667300,23,6,2,Office Supplies,Binders,17,17,12
AZ-2013-3680670,348,143,11,Office Supplies,Binders,205,205,1573
AZ-2013-3688598,23,-2,3,Office Supplies,Storage,25,25,-6
AZ-2013-3692060,165,30,3,Office Supplies,Art,135,135,90
AZ-2013-3726775,1973,767,5,Furniture,Bookcases,1206,1206,3835
AZ-2013-3726775,170,75,3,Furniture,Furnishings,95,95,225
AZ-2013-3726775,158,47,5,Office Supplies,Binders,10,111,235
AZ-2013-3733101,232,95,4,Technology,Phones,137,137,380
AZ-2013-3735155,32,6,3,Office Supplies,Labels,26,26,18
AZ-2013-3735155,83,2,5,Office Supplies,Paper,81,81,10
AZ-2013-374373,618,27,4,Furniture,Bookcases,591,591,108
AZ-2013-3751921,594,113,4,Technology,Copiers,481,481,452
AZ-2013-3797817,95,18,5,Office Supplies,Art,46,77,90
AZ-2013-3797817,54,17,4,Office Supplies,Fasteners,37,37,68
AZ-2013-3807321,40,15,6,Office Supplies,Binders,12,25,90
AZ-2013-3807660,24,11,1,Office Supplies,Supplies,13,13,11
AZ-2013-3816496,24,0,2,Office Supplies,Art,24,24,0
AZ-2013-3848149,244,29,5,Office Supplies,Binders,215,215,145
AZ-2013-3863359,54,4,3,Office Supplies,Art,50,50,12
AZ-2013-3863768,7,-4,2,Office Supplies,Binders,11,11,-8
AZ-2013-3867309,11,5,2,Office Supplies,Binders,6,6,10
AZ-2013-3873632,57,6,4,Office Supplies,Art,51,51,24
AZ-2013-3881285,48,9,4,Office Supplies,Fasteners,39,39,36
AZ-2013-388293,1051,315,6,Furniture,Bookcases,736,736,1890
AZ-2013-388293,59,22,7,Office Supplies,Binders,37,37,154
AZ-2013-3888761,256,83,5,Furniture,Chairs,173,173,415
AZ-2013-3888761,50,13,2,Office Supplies,Binders,37,37,26
AZ-2013-3888761,39,15,6,Office Supplies,Envelopes,24,24,90
AZ-2013-3893107,21,5,2,Office Supplies,Binders,16,16,10
AZ-2013-3893107,130,13,3,Technology,Accessories,117,117,39
AZ-2013-3893358,244,110,5,Furniture,Furnishings,134,134,550
AZ-2013-3893358,83,12,3,Office Supplies,Art,71,71,36
AZ-2013-3893358,28,14,4,Office Supplies,Binders,14,14,56
AZ-2013-3911329,2906,-156,10,Furniture,Bookcases,376,3062,-1560
AZ-2013-3911329,46,21,6,Office Supplies,Binders,25,25,126
AZ-2013-3911329,68,24,5,Office Supplies,Labels,44,44,120
AZ-2013-3923092,52,5,3,Office Supplies,Art,47,47,15
AZ-2013-3926345,559,-19,2,Office Supplies,Appliances,578,578,-38
AZ-2013-3926345,132,11,7,Office Supplies,Fasteners,121,121,77
AZ-2013-3932419,585,88,4,Furniture,Bookcases,497,497,352
AZ-2013-3932419,117,27,6,Office Supplies,Art,60,90,162
AZ-2013-3932419,30,12,2,Office Supplies,Fasteners,18,18,24
AZ-2013-3932419,74,4,4,Office Supplies,Paper,70,70,16
AZ-2013-393672,151,41,6,Office Supplies,Art,60,110,246
AZ-2013-393672,48,5,3,Office Supplies,Fasteners,43,43,15
AZ-2013-393672,154,46,5,Technology,Accessories,108,108,230
AZ-2013-393672,419,-44,4,Technology,Phones,463,463,-176
AZ-2013-3945159,43,17,1,Office Supplies,Storage,26,26,17
AZ-2013-3946948,164,64,4,Office Supplies,Envelopes,100,100,256
AZ-2013-3949241,146,-167,3,Technology,Phones,313,313,-501
AZ-2013-3963100,1110,144,2,Technology,Phones,966,966,288
AZ-2013-3983168,71,-54,3,Furniture,Chairs,125,125,-162
AZ-2013-3983168,214,-148,11,Office Supplies,Binders,115,362,-1628
AZ-2013-3983168,27,-9,2,Office Supplies,Envelopes,36,36,-18
AZ-2013-3983168,613,-343,7,Technology,Machines,956,956,-2401
AZ-2013-4001460,40,1,3,Office Supplies,Binders,39,39,3
AZ-2013-40070,614,179,15,Office Supplies,Art,234,435,2685
AZ-2013-4015759,245,15,3,Technology,Accessories,230,230,45
AZ-2013-405028,247,31,5,Office Supplies,Storage,216,216,155
AZ-2013-4071226,59,0,3,Office Supplies,Paper,59,59,0
AZ-2013-4084641,1817,799,5,Furniture,Bookcases,1018,1018,3995
AZ-2013-4084641,137,63,3,Office Supplies,Art,74,74,189
AZ-2013-4084641,125,15,3,Office Supplies,Supplies,110,110,45
AZ-2013-4092169,12,2,1,Office Supplies,Labels,10,10,2
AZ-2013-4092169,625,6,2,Technology,Machines,619,619,12
AZ-2013-4105375,17,4,2,Office Supplies,Storage,13,13,8
AZ-2013-4109586,133,44,3,Office Supplies,Art,89,89,132
AZ-2013-4109586,57,12,2,Office Supplies,Binders,45,45,24
AZ-2013-4109586,378,34,1,Technology,Copiers,344,344,34
AZ-2013-412985,376,131,18,Office Supplies,Art,60,245,2358
AZ-2013-412985,77,31,4,Office Supplies,Fasteners,46,46,124
AZ-2013-412985,32,5,3,Office Supplies,Labels,27,27,15
AZ-2013-412985,54,17,3,Office Supplies,Paper,37,37,51
AZ-2013-412985,254,89,3,Technology,Machines,165,165,267
AZ-2013-4133988,67,0,3,Furniture,Furnishings,67,67,0
AZ-2013-4133988,197,-30,1,Furniture,Tables,227,227,-30
AZ-2013-4134876,618,206,5,Office Supplies,Storage,412,412,1030
AZ-2013-4147824,298,74,2,Furniture,Bookcases,224,224,148
AZ-2013-4147824,116,22,5,Office Supplies,Art,94,94,110
AZ-2013-4148381,41,8,3,Office Supplies,Fasteners,33,33,24
AZ-2013-4155964,146,18,7,Office Supplies,Storage,128,128,126
AZ-2013-4187412,86,9,3,Office Supplies,Paper,77,77,27
AZ-2013-4218614,535,128,5,Furniture,Furnishings,407,407,640
AZ-2013-4218614,209,84,7,Office Supplies,Binders,125,125,588
AZ-2013-4231059,45,0,5,Office Supplies,Envelopes,45,45,0
AZ-2013-4231059,1427,297,14,Office Supplies,Storage,943,1130,4158
AZ-2013-4231059,32,11,2,Office Supplies,Supplies,21,21,22
AZ-2013-4238968,304,-292,6,Technology,Accessories,596,596,-1752
AZ-2013-4243411,84,21,4,Office Supplies,Storage,63,63,84
AZ-2013-424654,164,31,2,Technology,Phones,133,133,62
AZ-2013-425562,209,-121,5,Furniture,Chairs,330,330,-605
AZ-2013-425562,40,9,1,Furniture,Furnishings,31,31,9
AZ-2013-425562,107,-88,7,Office Supplies,Binders,195,195,-616
AZ-2013-425562,1428,-438,6,Technology,Phones,272,1866,-2628
AZ-2013-4266706,128,59,2,Furniture,Chairs,69,69,118
AZ-2013-4266706,167,63,10,Office Supplies,Fasteners,104,104,630
AZ-2013-4266706,383,180,2,Technology,Copiers,203,203,360
AZ-2013-4267689,376,30,7,Office Supplies,Art,346,346,210
AZ-2013-4270780,90,27,2,Technology,Accessories,63,63,54
AZ-2013-4284308,69,11,2,Office Supplies,Storage,58,58,22
AZ-2013-4301182,130,2,3,Office Supplies,Storage,128,128,6
AZ-2013-4304749,255,13,5,Office Supplies,Envelopes,242,242,65
AZ-2013-4304749,44,10,1,Office Supplies,Supplies,34,34,10
AZ-2013-4309368,130,16,2,Furniture,Chairs,114,114,32
AZ-2013-4309368,141,28,8,Office Supplies,Paper,113,113,224
AZ-2013-4309368,418,148,5,Office Supplies,Storage,42,270,740
AZ-2013-4309368,510,-24,2,Technology,Machines,534,534,-48
AZ-2013-4313910,50,12,4,Office Supplies,Binders,22,38,48
AZ-2013-4313910,159,28,6,Office Supplies,Paper,131,131,168
AZ-2013-4327909,36,-49,2,Furniture,Furnishings,85,85,-98
AZ-2013-4327909,20,-3,2,Office Supplies,Art,23,23,-6
AZ-2013-4327909,14,-4,2,Office Supplies,Fasteners,18,18,-8
AZ-2013-4330374,492,5,4,Furniture,Bookcases,487,487,20
AZ-2013-4330374,989,-435,4,Furniture,Tables,1424,1424,-1740
AZ-2013-4330374,276,62,10,Office Supplies,Binders,120,214,620
AZ-2013-4330374,66,11,4,Office Supplies,Paper,55,55,44
AZ-2013-4330374,111,19,4,Office Supplies,Supplies,92,92,76
AZ-2013-4330374,66,-36,1,Technology,Machines,102,102,-36
AZ-2013-4345897,15,5,1,Office Supplies,Fasteners,10,10,5
AZ-2013-4345897,77,12,2,Office Supplies,Storage,65,65,24
AZ-2013-4349254,245,30,2,Office Supplies,Storage,215,215,60
AZ-2013-4362020,63,14,6,Office Supplies,Binders,49,49,84
AZ-2013-4378960,19,4,1,Office Supplies,Art,15,15,4
AZ-2013-4382245,30,15,3,Office Supplies,Art,15,15,45
AZ-2013-4386533,964,395,9,Furniture,Furnishings,569,569,3555
AZ-2013-4391469,312,147,11,Office Supplies,Supplies,165,165,1617
AZ-2013-4414400,35,-13,3,Furniture,Furnishings,48,48,-39
AZ-2013-4414400,167,-89,11,Office Supplies,Supplies,133,256,-979
AZ-2013-4416490,341,160,7,Office Supplies,Art,181,181,1120
AZ-2013-4420211,1115,178,9,Technology,Copiers,937,937,1602
AZ-2013-4421845,202,22,4,Office Supplies,Binders,180,180,88
AZ-2013-4450786,173,40,11,Office Supplies,Storage,133,133,440
AZ-2013-4462556,40,6,3,Office Supplies,Paper,34,34,18
AZ-2013-4467970,339,102,7,Office Supplies,Binders,237,237,714
AZ-2013-4468276,242,82,8,Office Supplies,Art,160,160,656
AZ-2013-4503125,38,14,2,Office Supplies,Art,24,24,28
AZ-2013-4503283,2479,1019,6,Furniture,Chairs,1460,1460,6114
AZ-2013-4503283,254,31,7,Furniture,Furnishings,181,223,217
AZ-2013-4503283,188,-18,2,Technology,Machines,206,206,-36
AZ-2013-4505050,154,35,8,Office Supplies,Art,119,119,280
AZ-2013-4505050,76,11,7,Office Supplies,Labels,65,65,77
AZ-2013-4514932,34,14,2,Office Supplies,Art,20,20,28
AZ-2013-4514932,66,16,5,Office Supplies,Fasteners,50,50,80
AZ-2013-4520943,409,143,3,Furniture,Chairs,266,266,429
AZ-2013-4520943,16,5,3,Office Supplies,Binders,11,11,15
AZ-2013-4525210,229,75,5,Office Supplies,Envelopes,154,154,375
AZ-2013-4544800,75,4,3,Office Supplies,Art,71,71,12
AZ-2013-4589605,13,-7,1,Office Supplies,Paper,20,20,-7
AZ-2013-4589605,114,-21,4,Office Supplies,Storage,135,135,-84
AZ-2013-4589605,141,-113,2,Technology,Phones,254,254,-226
AZ-2013-4599374,105,28,2,Office Supplies,Paper,77,77,56
AZ-2013-4602895,207,2,7,Office Supplies,Envelopes,205,205,14
AZ-2013-4627833,778,62,2,Furniture,Bookcases,716,716,124
AZ-2013-4627833,899,396,2,Furniture,Tables,503,503,792
AZ-2013-4627833,27,11,4,Office Supplies,Binders,16,16,44
AZ-2013-4629929,800,168,3,Technology,Machines,632,632,504
AZ-2013-4637331,34,14,1,Office Supplies,Paper,20,20,14
AZ-2013-4640958,36,8,4,Office Supplies,Labels,28,28,32
AZ-2013-4640958,291,78,6,Office Supplies,Storage,213,213,468
AZ-2013-467128,206,33,9,Office Supplies,Envelopes,173,173,297
AZ-2013-4671281,39,7,1,Technology,Accessories,32,32,7
AZ-2013-4689502,507,175,4,Furniture,Chairs,332,332,700
AZ-2013-4695676,197,79,4,Office Supplies,Binders,118,118,316
AZ-2013-4695676,77,5,4,Office Supplies,Supplies,72,72,20
AZ-2013-469953,146,7,3,Furniture,Furnishings,139,139,21
AZ-2013-4721173,76,25,3,Office Supplies,Art,51,51,75
AZ-2013-4737507,31,11,5,Office Supplies,Binders,11,20,55
AZ-2013-4737507,594,-297,5,Office Supplies,Storage,891,891,-1485
AZ-2013-4750547,54,4,1,Office Supplies,Art,50,50,4
AZ-2013-4750547,514,195,13,Office Supplies,Envelopes,319,319,2535
AZ-2013-4756629,4618,924,9,Office Supplies,Appliances,3694,3694,8316
AZ-2013-4756629,71,25,3,Office Supplies,Storage,46,46,75
AZ-2013-4775573,45,0,2,Office Supplies,Art,45,45,0
AZ-2013-4775573,13,5,1,Office Supplies,Envelopes,8,8,5
AZ-2013-4775573,29,0,2,Office Supplies,Supplies,29,29,0
AZ-2013-4778996,81,29,5,Office Supplies,Fasteners,52,52,145
AZ-2013-4780772,848,367,2,Furniture,Chairs,481,481,734
AZ-2013-4821824,17,8,2,Office Supplies,Labels,9,9,16
AZ-2013-4821824,145,7,5,Office Supplies,Supplies,138,138,35
AZ-2013-4827275,1184,-182,6,Furniture,Tables,1366,1366,-1092
AZ-2013-4827275,27,8,1,Office Supplies,Binders,19,19,8
AZ-2013-4847875,27,6,4,Office Supplies,Binders,21,21,24
AZ-2013-4847875,177,71,2,Technology,Phones,106,106,142
AZ-2013-4856261,8,1,2,Office Supplies,Binders,7,7,2
AZ-2013-487438,445,209,4,Furniture,Furnishings,236,236,836
AZ-2013-487438,32,5,3,Office Supplies,Fasteners,27,27,15
AZ-2013-487438,300,-125,3,Technology,Phones,425,425,-375
AZ-2013-4874809,873,61,1,Furniture,Tables,812,812,61
AZ-2013-4874809,40,20,4,Office Supplies,Art,20,20,80
AZ-2013-4874809,48,2,4,Office Supplies,Binders,46,46,8
AZ-2013-4878818,26,7,3,Office Supplies,Envelopes,19,19,21
AZ-2013-4881884,16,6,2,Office Supplies,Binders,10,10,12
AZ-2013-4881884,11,4,1,Office Supplies,Storage,7,7,4
AZ-2013-4881884,159,53,2,Technology,Phones,106,106,106
AZ-2013-4888729,52,18,2,Office Supplies,Art,34,34,36
AZ-2013-4909261,33,-31,3,Furniture,Furnishings,64,64,-93
AZ-2013-4915584,15,0,2,Office Supplies,Labels,15,15,0
AZ-2013-4935792,1041,208,7,Furniture,Bookcases,833,833,1456
AZ-2013-4935792,92,-17,2,Furniture,Chairs,109,109,-34
AZ-2013-4950789,70,6,4,Office Supplies,Art,64,64,24
AZ-2013-4953096,73,4,1,Technology,Phones,69,69,4
AZ-2013-4958112,249,70,5,Office Supplies,Binders,179,179,350
AZ-2013-4962412,239,-131,4,Furniture,Bookcases,370,370,-524
AZ-2013-4982500,256,57,5,Office Supplies,Appliances,199,199,285
AZ-2013-4982500,13,0,3,Office Supplies,Binders,13,13,0
AZ-2013-4982500,54,-3,3,Office Supplies,Storage,57,57,-9
AZ-2013-4983076,80,3,3,Office Supplies,Art,77,77,9
AZ-2013-5004800,40,3,4,Office Supplies,Storage,37,37,12
AZ-2013-5007894,158,28,3,Office Supplies,Paper,130,130,84
AZ-2013-5007894,55,-1,2,Office Supplies,Storage,56,56,-2
AZ-2013-5013285,75,4,3,Office Supplies,Envelopes,71,71,12
AZ-2013-5013285,409,78,5,Technology,Phones,331,331,390
AZ-2013-5020127,342,154,7,Furniture,Furnishings,188,188,1078
AZ-2013-5022500,288,93,10,Office Supplies,Art,140,195,930
AZ-2013-5022500,278,42,6,Technology,Accessories,236,236,252
AZ-2013-5023304,439,220,9,Furniture,Furnishings,219,219,1980
AZ-2013-5023304,179,38,6,Office Supplies,Paper,141,141,228
AZ-2013-5024035,83,22,2,Office Supplies,Supplies,61,61,44
AZ-2013-5024035,62,20,1,Technology,Phones,42,42,20
AZ-2013-5029769,159,73,3,Office Supplies,Binders,86,86,219
AZ-2013-503783,299,116,4,Office Supplies,Appliances,183,183,464
AZ-2013-5049068,220,77,4,Office Supplies,Art,143,143,308
AZ-2013-5049068,101,11,2,Office Supplies,Binders,90,90,22
AZ-2013-5049068,485,199,11,Technology,Accessories,286,286,2189
AZ-2013-5054484,509,215,6,Furniture,Chairs,294,294,1290
AZ-2013-5054484,330,125,3,Furniture,Furnishings,205,205,375
AZ-2013-5054484,2910,-69,11,Technology,Machines,2979,2979,-759
AZ-2013-5073437,2699,890,9,Office Supplies,Appliances,1809,1809,8010
AZ-2013-5078982,435,104,3,Furniture,Bookcases,331,331,312
AZ-2013-5078982,222,38,7,Office Supplies,Art,72,184,266
AZ-2013-5078982,78,31,4,Office Supplies,Fasteners,47,47,124
AZ-2013-5078982,132,54,5,Office Supplies,Storage,78,78,270
AZ-2013-5080329,1234,234,3,Furniture,Bookcases,1000,1000,702
AZ-2013-5080329,97,24,2,Furniture,Chairs,73,73,48
AZ-2013-5080329,30,0,1,Office Supplies,Art,30,30,0
AZ-2013-5080329,24,6,2,Office Supplies,Envelopes,18,18,12
AZ-2013-5080329,85,4,3,Office Supplies,Paper,81,81,12
AZ-2013-5098610,52,18,3,Office Supplies,Envelopes,34,34,54
AZ-2013-5098610,636,146,2,Technology,Copiers,490,490,292
AZ-2013-5105869,329,4,1,Furniture,Bookcases,325,325,4
AZ-2013-5105869,44,20,5,Office Supplies,Binders,24,24,100
AZ-2013-5105869,9,3,2,Office Supplies,Labels,6,6,6
AZ-2013-5109758,205,80,3,Furniture,Chairs,125,125,240
AZ-2013-5111226,351,130,8,Office Supplies,Supplies,221,221,1040
AZ-2013-5119241,23,7,1,Furniture,Furnishings,16,16,7
AZ-2013-5129738,265,16,1,Technology,Machines,249,249,16
AZ-2013-514830,62,15,5,Office Supplies,Labels,47,47,75
AZ-2013-5176501,207,6,4,Office Supplies,Art,201,201,24
AZ-2013-5176501,66,14,3,Office Supplies,Supplies,52,52,42
AZ-2013-5176501,322,-30,2,Technology,Copiers,352,352,-60
AZ-2013-5213862,209,2,7,Office Supplies,Envelopes,207,207,14
AZ-2013-5213862,164,71,3,Office Supplies,Storage,93,93,213
AZ-2013-5227622,369,140,3,Furniture,Bookcases,229,229,420
AZ-2013-5248239,905,81,3,Office Supplies,Appliances,824,824,243
AZ-2013-5248239,401,111,11,Office Supplies,Art,77,290,1221
AZ-2013-5248239,57,28,2,Office Supplies,Envelopes,29,29,56
AZ-2013-5248239,1954,782,3,Technology,Phones,1172,1172,2346
AZ-2013-5249533,207,31,4,Office Supplies,Art,176,176,124
AZ-2013-5265253,475,26,2,Technology,Machines,449,449,52
AZ-2013-5279450,970,216,2,Office Supplies,Appliances,754,754,432
AZ-2013-5292560,12,1,3,Office Supplies,Binders,11,11,3
AZ-2013-5292560,42,5,2,Office Supplies,Storage,37,37,10
AZ-2013-5301582,56,-44,4,Office Supplies,Art,100,100,-176
AZ-2013-5306742,256,17,2,Office Supplies,Storage,239,239,34
AZ-2013-5306742,445,-73,2,Technology,Copiers,518,518,-146
AZ-2013-5316268,371,41,3,Furniture,Bookcases,330,330,123
AZ-2013-5316268,2637,949,5,Office Supplies,Appliances,1688,1688,4745
AZ-2013-5316268,26,8,2,Office Supplies,Art,18,18,16
AZ-2013-5316268,363,110,12,Office Supplies,Paper,132,253,1320
AZ-2013-5325504,95,38,6,Furniture,Furnishings,57,57,228
AZ-2013-5325504,116,48,4,Office Supplies,Art,68,68,192
AZ-2013-5325504,32,8,3,Office Supplies,Binders,24,24,24
AZ-2013-5325504,15,6,1,Office Supplies,Storage,9,9,6
AZ-2013-5337437,100,33,2,Office Supplies,Art,67,67,66
AZ-2013-5337437,136,22,4,Office Supplies,Supplies,114,114,88
AZ-2013-5337437,132,-61,3,Technology,Phones,193,193,-183
AZ-2013-5340788,14,7,3,Office Supplies,Binders,7,7,21
AZ-2013-5358584,45,2,2,Furniture,Furnishings,43,43,4
AZ-2013-5414394,34,12,3,Office Supplies,Labels,22,22,36
AZ-2013-5414394,251,55,8,Office Supplies,Supplies,196,196,440
AZ-2013-5416676,126,12,5,Office Supplies,Art,102,114,60
AZ-2013-5420314,510,71,3,Technology,Machines,439,439,213
AZ-2013-5458783,15,-3,1,Office Supplies,Binders,18,18,-3
AZ-2013-5465324,299,10,2,Furniture,Chairs,289,289,20
AZ-2013-5465324,86,18,3,Furniture,Furnishings,68,68,54
AZ-2013-5465324,215,71,13,Office Supplies,Art,109,144,923
AZ-2013-5465324,210,40,7,Office Supplies,Supplies,170,170,280
AZ-2013-5467266,149,11,10,Office Supplies,Binders,96,138,110
AZ-2013-5483858,636,146,2,Technology,Copiers,490,490,292
AZ-2013-5523176,154,28,7,Office Supplies,Art,126,126,196
AZ-2013-5523176,567,180,8,Technology,Machines,387,387,1440
AZ-2013-5523180,442,25,3,Furniture,Chairs,417,417,75
AZ-2013-5523180,334,157,3,Furniture,Furnishings,177,177,471
AZ-2013-5523180,104,2,5,Office Supplies,Storage,102,102,10
AZ-2013-5532307,98,39,2,Office Supplies,Binders,59,59,78
AZ-2013-5539829,176,8,1,Furniture,Tables,168,168,8
AZ-2013-5539829,88,16,4,Office Supplies,Art,72,72,64
AZ-2013-5548101,137,22,3,Office Supplies,Art,115,115,66
AZ-2013-5548332,326,107,3,Furniture,Furnishings,219,219,321
AZ-2013-5548332,44,7,4,Office Supplies,Fasteners,37,37,28
AZ-2013-5584344,118,2,5,Office Supplies,Art,116,116,10
AZ-2013-5594032,161,19,4,Technology,Accessories,142,142,76
AZ-2013-560367,74,12,5,Office Supplies,Storage,62,62,60
AZ-2013-5608850,1236,383,3,Furniture,Bookcases,853,853,1149
AZ-2013-5608850,75,5,3,Office Supplies,Art,70,70,15
AZ-2013-5608850,33,11,2,Office Supplies,Fasteners,22,22,22
AZ-2013-5608850,426,68,3,Office Supplies,Storage,358,358,204
AZ-2013-5608850,262,29,2,Technology,Phones,233,233,58
AZ-2013-5610868,114,3,3,Furniture,Chairs,111,111,9
AZ-2013-5618909,154,41,1,Furniture,Bookcases,113,113,41
AZ-2013-5637094,187,88,4,Office Supplies,Art,99,99,352
AZ-2013-5637964,212,76,9,Office Supplies,Binders,24,136,684
AZ-2013-5637964,2079,852,8,Technology,Accessories,1227,1227,6816
AZ-2013-5637964,760,236,2,Technology,Copiers,524,524,472
AZ-2013-5643375,1069,71,8,Furniture,Bookcases,998,998,568
AZ-2013-5643375,59,19,4,Office Supplies,Supplies,19,40,76
AZ-2013-5656522,442,31,3,Furniture,Bookcases,411,411,93
AZ-2013-5656522,57,15,5,Office Supplies,Binders,42,42,75
AZ-2013-5656522,389,58,7,Technology,Accessories,331,331,406
AZ-2013-5656522,1003,451,6,Technology,Machines,552,552,2706
AZ-2013-5670267,129,55,5,Office Supplies,Envelopes,74,74,275
AZ-2013-5683679,547,207,4,Furniture,Bookcases,340,340,828
AZ-2013-5687918,42,3,1,Furniture,Chairs,39,39,3
AZ-2013-5687918,136,12,2,Technology,Phones,124,124,24
AZ-2013-5696844,38,11,2,Furniture,Furnishings,27,27,22
AZ-2013-5702872,1708,512,7,Technology,Accessories,1196,1196,3584
AZ-2013-5712396,91,29,2,Office Supplies,Envelopes,62,62,58
AZ-2013-5712396,192,31,5,Office Supplies,Storage,161,161,155
AZ-2013-5719967,2764,-195,11,Technology,Copiers,2959,2959,-2145
AZ-2013-5719967,304,72,3,Technology,Machines,232,232,216
AZ-2013-5719967,2195,207,4,Technology,Phones,1988,1988,828
AZ-2013-5724915,56,6,14,Office Supplies,Binders,50,50,84
AZ-2013-5724915,80,2,2,Technology,Accessories,78,78,4
AZ-2013-5727420,44,14,4,Office Supplies,Binders,30,30,56
AZ-2013-5743431,1091,120,3,Furniture,Bookcases,971,971,360
AZ-2013-5743431,48,19,3,Furniture,Furnishings,29,29,57
AZ-2013-5743431,158,69,3,Office Supplies,Art,89,89,207
AZ-2013-5743431,140,46,5,Office Supplies,Binders,94,94,230
AZ-2013-5755463,618,206,5,Office Supplies,Storage,412,412,1030
AZ-2013-5764612,158,30,3,Office Supplies,Art,128,128,90
AZ-2013-5764612,272,44,6,Office Supplies,Storage,86,228,264
AZ-2013-5764612,214,18,3,Technology,Machines,196,196,54
AZ-2013-576501,7,1,1,Office Supplies,Binders,6,6,1
AZ-2013-5776875,1550,139,6,Technology,Accessories,1411,1411,834
AZ-2013-577789,14,5,1,Office Supplies,Binders,9,9,5
AZ-2013-5794364,349,35,7,Office Supplies,Envelopes,314,314,245
AZ-2013-5796151,1677,309,3,Furniture,Tables,1368,1368,927
AZ-2013-5796151,358,68,8,Office Supplies,Art,290,290,544
AZ-2013-5796151,19,6,2,Office Supplies,Labels,13,13,12
AZ-2013-5802443,20,5,4,Office Supplies,Binders,15,15,20
AZ-2013-5815303,22,6,2,Office Supplies,Binders,16,16,12
AZ-2013-5815303,20,4,2,Office Supplies,Labels,10,16,8
AZ-2013-5832264,17,8,2,Office Supplies,Envelopes,9,9,16
AZ-2013-5833673,80,3,3,Office Supplies,Art,77,77,9
AZ-2013-5833673,43,2,3,Office Supplies,Binders,41,41,6
AZ-2013-5833673,41,8,3,Office Supplies,Fasteners,33,33,24
AZ-2013-5834532,654,247,2,Furniture,Bookcases,407,407,494
AZ-2013-5834532,137,55,4,Office Supplies,Appliances,82,82,220
AZ-2013-5834532,145,32,11,Office Supplies,Binders,44,113,352
AZ-2013-584575,142,23,4,Office Supplies,Storage,79,119,92
AZ-2013-584575,269,91,3,Technology,Phones,178,178,273
AZ-2013-5850386,24,-10,1,Office Supplies,Paper,34,34,-10
AZ-2013-5850386,78,-72,6,Technology,Accessories,150,150,-432
AZ-2013-5864378,181,16,7,Office Supplies,Art,153,165,112
AZ-2013-587420,9,2,1,Office Supplies,Binders,7,7,2
AZ-2013-588025,123,17,3,Furniture,Furnishings,106,106,51
AZ-2013-588025,193,96,6,Office Supplies,Art,97,97,576
AZ-2013-589374,142,70,5,Office Supplies,Envelopes,72,72,350
AZ-2013-589374,72,16,3,Office Supplies,Supplies,56,56,48
AZ-2013-5900353,181,29,6,Office Supplies,Art,152,152,174
AZ-2013-5900353,97,2,2,Office Supplies,Storage,95,95,4
AZ-2013-5900353,1063,266,7,Technology,Phones,797,797,1862
AZ-2013-5931523,164,78,3,Office Supplies,Art,86,86,234
AZ-2013-5932628,448,81,3,Furniture,Bookcases,367,367,243
AZ-2013-5932628,40,8,2,Furniture,Furnishings,32,32,16
AZ-2013-5932628,1987,338,4,Office Supplies,Appliances,1649,1649,1352
AZ-2013-5932628,165,30,3,Office Supplies,Art,135,135,90
AZ-2013-5932628,59,21,2,Office Supplies,Binders,38,38,42
AZ-2013-5932628,149,67,5,Office Supplies,Paper,82,82,335
AZ-2013-5932628,49,8,5,Office Supplies,Storage,41,41,40
AZ-2013-5937615,50,19,3,Office Supplies,Fasteners,31,31,57
AZ-2013-5937615,53,26,2,Office Supplies,Storage,27,27,52
AZ-2013-5944136,116,7,2,Furniture,Furnishings,109,109,14
AZ-2013-5945845,247,69,2,Technology,Phones,178,178,138
AZ-2013-5949310,154,39,3,Office Supplies,Binders,115,115,117
AZ-2013-5949310,246,71,4,Technology,Phones,63,175,284
AZ-2013-5949535,140,59,7,Office Supplies,Binders,63,81,413
AZ-2013-5949535,441,207,3,Technology,Copiers,234,234,621
AZ-2013-5956200,293,36,6,Office Supplies,Storage,257,257,216
AZ-2013-5956200,50,23,2,Office Supplies,Supplies,27,27,46
AZ-2013-5970660,48,4,1,Office Supplies,Supplies,44,44,4
AZ-2013-5973839,107,32,2,Furniture,Furnishings,75,75,64
AZ-2013-5973839,100,28,2,Office Supplies,Binders,72,72,56
AZ-2013-5973839,178,52,4,Office Supplies,Supplies,126,126,208
AZ-2013-5974172,592,-643,12,Technology,Copiers,1235,1235,-7716
AZ-2013-5987890,129,49,4,Office Supplies,Art,80,80,196
AZ-2013-5987890,484,213,4,Technology,Machines,271,271,852
AZ-2013-5998072,22,-41,5,Furniture,Furnishings,63,63,-205
AZ-2013-5998072,14,-13,2,Office Supplies,Binders,27,27,-26
AZ-2013-5999783,159,21,2,Technology,Accessories,138,138,42
AZ-2013-6016328,105,20,2,Office Supplies,Art,85,85,40
AZ-2013-6030964,82,12,2,Technology,Accessories,70,70,24
AZ-2013-6051551,99,24,2,Office Supplies,Art,75,75,48
AZ-2013-6051551,46,9,4,Office Supplies,Labels,37,37,36
AZ-2013-6053610,159,60,3,Furniture,Furnishings,99,99,180
AZ-2013-6053610,25,11,3,Office Supplies,Fasteners,14,14,33
AZ-2013-6062232,47,-17,2,Furniture,Furnishings,64,64,-34
AZ-2013-6063955,103,36,4,Office Supplies,Art,67,67,144
AZ-2013-6063955,587,65,4,Technology,Copiers,522,522,260
AZ-2013-6085124,49,20,2,Office Supplies,Art,29,29,40
AZ-2013-6085124,37,9,1,Technology,Machines,28,28,9
AZ-2013-6085287,52,19,1,Office Supplies,Art,33,33,19
AZ-2013-6085287,49,9,2,Office Supplies,Supplies,40,40,18
AZ-2013-6101031,426,136,9,Furniture,Furnishings,290,290,1224
AZ-2013-6101031,44,9,3,Office Supplies,Art,35,35,27
AZ-2013-6101031,29,1,3,Office Supplies,Envelopes,28,28,3
AZ-2013-6101031,107,9,1,Technology,Phones,98,98,9
AZ-2013-6105265,632,7,6,Technology,Copiers,625,625,42
AZ-2013-6105265,111,27,3,Technology,Machines,84,84,81
AZ-2013-6121627,51,24,3,Office Supplies,Storage,27,27,72
AZ-2013-6121627,510,250,3,Technology,Copiers,260,260,750
AZ-2013-6122877,54,4,3,Office Supplies,Art,50,50,12
AZ-2013-6132734,44,0,2,Furniture,Furnishings,44,44,0
AZ-2013-6138648,1032,298,8,Furniture,Chairs,734,734,2384
AZ-2013-6138648,151,47,3,Furniture,Furnishings,104,104,141
AZ-2013-6138648,185,48,4,Office Supplies,Art,137,137,192
AZ-2013-6141495,43,5,3,Office Supplies,Art,38,38,15
AZ-2013-6141495,1016,228,6,Office Supplies,Storage,473,788,1368
AZ-2013-6143126,72,19,3,Office Supplies,Envelopes,53,53,57
AZ-2013-6147985,26,10,2,Office Supplies,Binders,16,16,20
AZ-2013-6147985,86,37,8,Office Supplies,Labels,49,49,296
AZ-2013-6147985,110,26,2,Office Supplies,Storage,84,84,52
AZ-2013-61597,552,165,5,Furniture,Bookcases,387,387,825
AZ-2013-6181166,43,9,3,Office Supplies,Binders,34,34,27
AZ-2013-6181166,1519,182,4,Technology,Copiers,1337,1337,728
AZ-2013-6181166,104,6,2,Technology,Machines,98,98,12
AZ-2013-6183713,233,67,8,Office Supplies,Binders,166,166,536
AZ-2013-6220959,2432,513,5,Office Supplies,Appliances,1919,1919,2565
AZ-2013-6220959,24,7,4,Office Supplies,Binders,17,17,28
AZ-2013-6220959,279,98,8,Office Supplies,Envelopes,89,181,784
AZ-2013-6220959,217,70,9,Office Supplies,Paper,63,147,630
AZ-2013-6224487,2959,953,7,Furniture,Chairs,2006,2006,6671
AZ-2013-6231754,39,9,1,Furniture,Furnishings,30,30,9
AZ-2013-6241714,343,72,5,Office Supplies,Appliances,271,271,360
AZ-2013-6241714,280,62,11,Office Supplies,Art,101,218,682
AZ-2013-6242491,283,48,2,Office Supplies,Storage,235,235,96
AZ-2013-6244362,292,35,4,Technology,Phones,257,257,140
AZ-2013-6246292,120,23,4,Office Supplies,Binders,97,97,92
AZ-2013-6261184,1545,-547,5,Furniture,Tables,2092,2092,-2735
AZ-2013-6261184,27,6,2,Office Supplies,Paper,21,21,12
AZ-2013-627487,18,9,4,Office Supplies,Binders,9,9,36
AZ-2013-627487,52,18,3,Office Supplies,Envelopes,34,34,54
AZ-2013-6301171,259,59,7,Office Supplies,Envelopes,200,200,413
AZ-2013-6302764,41,16,2,Office Supplies,Envelopes,25,25,32
AZ-2013-6302764,26,12,3,Office Supplies,Labels,14,14,36
AZ-2013-6302764,89,26,2,Office Supplies,Supplies,63,63,52
AZ-2013-6313494,175,14,6,Office Supplies,Art,84,161,84
AZ-2013-6322927,198,63,8,Office Supplies,Art,135,135,504
AZ-2013-6322927,1288,423,12,Office Supplies,Storage,405,865,5076
AZ-2013-6322927,79,28,3,Office Supplies,Supplies,51,51,84
AZ-2013-6334025,133,44,3,Office Supplies,Art,89,89,132
AZ-2013-6337474,459,101,4,Technology,Accessories,358,358,404
AZ-2013-6337474,692,290,4,Technology,Copiers,402,402,1160
AZ-2013-6362222,234,47,6,Office Supplies,Binders,143,187,282
AZ-2013-6362222,79,-6,5,Office Supplies,Storage,85,85,-30
AZ-2013-6362222,738,147,6,Technology,Phones,591,591,882
AZ-2013-6371048,457,102,2,Technology,Machines,355,355,204
AZ-2013-6379416,179,69,1,Office Supplies,Storage,110,110,69
AZ-2013-6383663,433,48,4,Furniture,Furnishings,385,385,192
AZ-2013-6383663,293,42,6,Office Supplies,Appliances,251,251,252
AZ-2013-6383663,45,17,7,Office Supplies,Binders,28,28,119
AZ-2013-6383663,69,25,4,Office Supplies,Fasteners,44,44,100
AZ-2013-6383663,263,71,5,Office Supplies,Paper,192,192,355
AZ-2013-6396086,208,-100,9,Office Supplies,Art,308,308,-900
AZ-2013-6397384,23,4,2,Office Supplies,Labels,19,19,8
AZ-2013-6399452,632,57,9,Technology,Accessories,575,575,513
AZ-2013-6408423,52,9,1,Office Supplies,Binders,43,43,9
AZ-2013-6411622,40,16,3,Office Supplies,Binders,24,24,48
AZ-2013-6415803,173,15,4,Office Supplies,Storage,158,158,60
AZ-2013-6417949,725,145,5,Furniture,Chairs,580,580,725
AZ-2013-6417949,92,24,8,Office Supplies,Binders,68,68,192
AZ-2013-6417949,148,34,4,Office Supplies,Envelopes,114,114,136
AZ-2013-6417949,31,1,2,Office Supplies,Storage,30,30,2
AZ-2013-6417949,1901,589,5,Technology,Copiers,1312,1312,2945
AZ-2013-6417949,2606,1042,4,Technology,Phones,1564,1564,4168
AZ-2013-6437122,60,16,3,Office Supplies,Art,44,44,48
AZ-2013-6437122,45,7,3,Office Supplies,Storage,38,38,21
AZ-2013-6438316,72,4,5,Office Supplies,Binders,68,68,20
AZ-2013-6440318,249,79,4,Technology,Phones,170,170,316
AZ-2013-6450064,47,16,2,Office Supplies,Art,31,31,32
AZ-2013-6450064,38,17,3,Office Supplies,Binders,21,21,51
AZ-2013-6487412,371,115,1,Furniture,Bookcases,256,256,115
AZ-2013-649774,506,192,3,Furniture,Bookcases,314,314,576
AZ-2013-649774,8,3,1,Office Supplies,Binders,5,5,3
AZ-2013-649774,228,114,2,Technology,Machines,114,114,228
AZ-2013-6499468,228,66,3,Office Supplies,Appliances,162,162,198
AZ-2013-6499468,109,34,3,Office Supplies,Art,25,75,102
AZ-2013-6499468,113,30,3,Office Supplies,Envelopes,83,83,90
AZ-2013-6499468,541,-32,2,Technology,Copiers,573,573,-64
AZ-2013-6510557,623,41,5,Office Supplies,Storage,582,582,205
AZ-2013-6514134,275,96,5,Office Supplies,Art,179,179,480
AZ-2013-6514134,18,8,2,Office Supplies,Labels,10,10,16
AZ-2013-6514734,147,31,5,Office Supplies,Binders,116,116,155
AZ-2013-6528182,56,9,3,Office Supplies,Fasteners,47,47,27
AZ-2013-6528182,41,11,4,Office Supplies,Storage,30,30,44
AZ-2013-6529496,800,168,3,Technology,Machines,632,632,504
AZ-2013-6529496,1908,820,3,Technology,Phones,1088,1088,2460
AZ-2013-6530870,44,14,4,Office Supplies,Labels,19,30,56
AZ-2013-6530870,517,46,2,Technology,Accessories,471,471,92
AZ-2013-6535655,62,6,5,Office Supplies,Binders,56,56,30
AZ-2013-6538,207,72,8,Office Supplies,Art,135,135,576
AZ-2013-6541057,63,19,1,Office Supplies,Storage,44,44,19
AZ-2013-6541057,202,28,4,Technology,Machines,174,174,112
AZ-2013-6548311,369,92,3,Furniture,Bookcases,277,277,276
AZ-2013-6548311,213,19,7,Office Supplies,Binders,194,194,133
AZ-2013-6548311,100,10,2,Office Supplies,Envelopes,90,90,20
AZ-2013-6551500,2900,928,7,Furniture,Bookcases,1972,1972,6496
AZ-2013-6552361,1284,560,9,Furniture,Bookcases,515,724,5040
AZ-2013-6552361,52,4,4,Office Supplies,Binders,48,48,16
AZ-2013-6552361,30,5,2,Office Supplies,Paper,25,25,10
AZ-2013-6552361,30,5,3,Office Supplies,Storage,25,25,15
AZ-2013-6557356,320,82,2,Furniture,Chairs,238,238,164
AZ-2013-6557356,29,10,2,Office Supplies,Binders,19,19,20
AZ-2013-6557356,79,39,2,Office Supplies,Supplies,40,40,78
AZ-2013-6557454,204,48,9,Furniture,Furnishings,156,156,432
AZ-2013-6565127,204,77,12,Office Supplies,Paper,127,127,924
AZ-2013-6593981,259,53,7,Office Supplies,Art,98,206,371
AZ-2013-6593981,45,2,2,Office Supplies,Paper,43,43,4
AZ-2013-6593981,156,47,3,Office Supplies,Storage,109,109,141
AZ-2013-6593981,276,80,5,Technology,Accessories,196,196,400
AZ-2013-6623035,165,58,3,Office Supplies,Art,107,107,174
AZ-2013-6623035,247,74,4,Office Supplies,Storage,173,173,296
AZ-2013-6636163,41,11,7,Office Supplies,Binders,30,30,77
AZ-2013-6636163,286,64,2,Technology,Copiers,222,222,128
AZ-2013-6652500,58,8,2,Office Supplies,Art,50,50,16
AZ-2013-6652500,27,6,3,Office Supplies,Binders,21,21,18
AZ-2013-6657478,438,66,3,Furniture,Bookcases,372,372,198
AZ-2013-6674334,330,145,3,Furniture,Furnishings,185,185,435
AZ-2013-6674334,44,-5,2,Office Supplies,Storage,49,49,-10
AZ-2013-6674334,68,11,2,Office Supplies,Supplies,57,57,22
AZ-2013-6674334,123,7,1,Technology,Phones,116,116,7
AZ-2013-6686311,106,0,8,Office Supplies,Storage,106,106,0
AZ-2013-6702716,19,8,3,Office Supplies,Binders,11,11,24
AZ-2013-6702716,40,10,3,Office Supplies,Envelopes,30,30,30
AZ-2013-6711717,214,88,2,Furniture,Furnishings,126,126,176
AZ-2013-6711717,211,35,8,Office Supplies,Art,129,176,280
AZ-2013-6727815,876,228,2,Furniture,Bookcases,648,648,456
AZ-2013-6727815,2843,256,9,Furniture,Tables,2587,2587,2304
AZ-2013-6727815,56,10,3,Office Supplies,Envelopes,46,46,30
AZ-2013-6727815,234,56,2,Technology,Machines,178,178,112
AZ-2013-673329,112,37,4,Office Supplies,Binders,75,75,148
AZ-2013-6736860,20,6,2,Office Supplies,Labels,14,14,12
AZ-2013-6736860,170,71,5,Office Supplies,Paper,99,99,355
AZ-2013-6736860,245,44,1,Technology,Accessories,201,201,44
AZ-2013-674584,174,54,3,Technology,Accessories,120,120,162
AZ-2013-6748917,12,1,1,Office Supplies,Binders,11,11,1
AZ-2013-6748917,114,17,10,Office Supplies,Fasteners,97,97,170
AZ-2013-6752610,45,4,4,Office Supplies,Art,41,41,16
AZ-2013-6776872,21,4,3,Office Supplies,Binders,17,17,12
AZ-2013-6776872,536,208,3,Office Supplies,Storage,328,328,624
AZ-2013-6776872,500,90,5,Technology,Accessories,410,410,450
AZ-2013-6788616,599,253,5,Furniture,Chairs,346,346,1265
AZ-2013-6788616,48,6,3,Furniture,Furnishings,42,42,18
AZ-2013-6788616,175,9,7,Office Supplies,Envelopes,166,166,63
AZ-2013-6788616,25,6,2,Office Supplies,Labels,19,19,12
AZ-2013-6788616,347,69,3,Office Supplies,Storage,278,278,207
AZ-2013-6795537,53,24,6,Office Supplies,Labels,29,29,144
AZ-2013-6796534,264,66,1,Technology,Copiers,198,198,66
AZ-2013-6800443,2037,359,9,Technology,Machines,1678,1678,3231
AZ-2013-6800942,628,-616,4,Technology,Machines,1244,1244,-2464
AZ-2013-6802973,899,80,2,Office Supplies,Appliances,819,819,160
AZ-2013-6808078,11,2,1,Office Supplies,Fasteners,9,9,2
AZ-2013-6808078,34,4,3,Office Supplies,Labels,30,30,12
AZ-2013-6813674,133,-4,3,Furniture,Chairs,137,137,-12
AZ-2013-6813674,16,7,2,Office Supplies,Binders,9,9,14
AZ-2013-6823803,314,66,6,Furniture,Furnishings,85,248,396
AZ-2013-6823803,308,142,14,Office Supplies,Paper,166,166,1988
AZ-2013-684636,96,2,4,Office Supplies,Storage,94,94,8
AZ-2013-686956,61,29,3,Office Supplies,Envelopes,32,32,87
AZ-2013-6873105,143,49,3,Furniture,Chairs,94,94,147
AZ-2013-6873105,2046,185,15,Office Supplies,Storage,214,1861,2775
AZ-2013-6873105,608,129,2,Technology,Copiers,479,479,258
AZ-2013-6875037,88,4,3,Office Supplies,Art,84,84,12
AZ-2013-6875037,18,5,1,Office Supplies,Paper,13,13,5
AZ-2013-6878951,56,26,3,Office Supplies,Storage,30,30,78
AZ-2013-6878951,1275,497,7,Technology,Phones,778,778,3479
AZ-2013-6918835,1348,445,7,Technology,Copiers,903,903,3115
AZ-2013-6920962,70,24,3,Office Supplies,Art,46,46,72
AZ-2013-6928032,11,3,1,Office Supplies,Binders,8,8,3
AZ-2013-6928032,27,6,2,Office Supplies,Paper,21,21,12
AZ-2013-6937323,49,22,2,Office Supplies,Envelopes,27,27,44
AZ-2013-6940271,114,45,6,Office Supplies,Art,69,69,270
AZ-2013-6943804,68,24,4,Office Supplies,Envelopes,44,44,96
AZ-2013-6943804,225,9,8,Technology,Accessories,216,216,72
AZ-2013-6948264,330,16,3,Furniture,Furnishings,314,314,48
AZ-2013-6948264,79,33,4,Office Supplies,Art,46,46,132
AZ-2013-6948264,1226,417,5,Technology,Copiers,809,809,2085
AZ-2013-695660,14,7,2,Office Supplies,Binders,7,7,14
AZ-2013-695660,87,23,5,Office Supplies,Envelopes,64,64,115
AZ-2013-696326,52,19,1,Furniture,Furnishings,33,33,19
AZ-2013-696326,9,1,1,Office Supplies,Storage,8,8,1
AZ-2013-6968684,123,33,4,Technology,Accessories,90,90,132
AZ-2013-6980084,1533,-34,3,Office Supplies,Appliances,1567,1567,-102
AZ-2013-6980084,260,78,5,Office Supplies,Storage,182,182,390
AZ-2013-6980364,576,51,5,Office Supplies,Storage,525,525,255
AZ-2013-6986515,1629,619,3,Office Supplies,Appliances,1010,1010,1857
AZ-2013-6987158,239,55,5,Office Supplies,Envelopes,184,184,275
AZ-2013-6987158,1282,105,4,Technology,Copiers,1177,1177,420
AZ-2013-699098,1622,324,3,Technology,Phones,1298,1298,972
AZ-2013-6996461,52,25,3,Furniture,Furnishings,27,27,75
AZ-2013-6996461,232,80,7,Office Supplies,Appliances,152,152,560
AZ-2013-6996461,99,41,5,Office Supplies,Art,58,58,205
AZ-2013-7001055,597,167,3,Office Supplies,Storage,430,430,501
AZ-2013-7004220,73,34,9,Office Supplies,Binders,39,39,306
AZ-2013-7004220,57,5,6,Office Supplies,Envelopes,52,52,30
AZ-2013-7006119,91,15,2,Office Supplies,Art,76,76,30
AZ-2013-7006119,1200,480,4,Technology,Copiers,720,720,1920
AZ-2013-7006260,233,70,2,Technology,Accessories,163,163,140
AZ-2013-7006260,174,71,1,Technology,Copiers,103,103,71
AZ-2013-701408,564,69,9,Furniture,Chairs,495,495,621
AZ-2013-7017402,205,-113,4,Furniture,Chairs,318,318,-452
AZ-2013-7017402,220,18,2,Furniture,Furnishings,202,202,36
AZ-2013-7017402,2070,414,4,Office Supplies,Appliances,1656,1656,1656
AZ-2013-7017402,98,-3,3,Office Supplies,Storage,101,101,-9
AZ-2013-7017402,278,42,5,Technology,Accessories,236,236,210
AZ-2013-7036951,180,11,4,Furniture,Furnishings,169,169,44
AZ-2013-7044470,38,5,2,Furniture,Furnishings,33,33,10
AZ-2013-7044470,59,21,2,Office Supplies,Art,38,38,42
AZ-2013-7058808,51,6,1,Furniture,Furnishings,45,45,6
AZ-2013-706916,53,22,2,Office Supplies,Supplies,31,31,44
AZ-2013-7074618,264,3,2,Technology,Copiers,261,261,6
AZ-2013-708571,359,28,5,Furniture,Chairs,331,331,140
AZ-2013-708571,364,69,8,Office Supplies,Art,264,295,552
AZ-2013-708571,227,-37,1,Technology,Machines,264,264,-37
AZ-2013-709456,67,-36,5,Office Supplies,Paper,103,103,-180
AZ-2013-7095053,55,15,2,Office Supplies,Binders,40,40,30
AZ-2013-7130503,119,39,5,Office Supplies,Paper,48,80,195
AZ-2013-7137093,86,31,8,Office Supplies,Art,55,55,248
AZ-2013-7137093,672,194,3,Technology,Accessories,478,478,582
AZ-2013-7143819,175,52,2,Office Supplies,Appliances,123,123,104
AZ-2013-7143819,41,20,3,Office Supplies,Fasteners,21,21,60
AZ-2013-7144565,135,38,5,Office Supplies,Supplies,97,97,190
AZ-2013-7146719,1269,14,3,Furniture,Chairs,1255,1255,42
AZ-2013-7162758,38,8,2,Office Supplies,Envelopes,30,30,16
AZ-2013-7190502,137,63,3,Office Supplies,Art,74,74,189
AZ-2013-7190502,39,4,2,Office Supplies,Envelopes,35,35,8
AZ-2013-7204222,49,4,2,Office Supplies,Envelopes,45,45,8
AZ-2013-7204904,164,24,4,Technology,Accessories,140,140,96
AZ-2013-7212941,27,8,2,Office Supplies,Binders,19,19,16
AZ-2013-7222036,115,6,2,Furniture,Chairs,109,109,12
AZ-2013-7222036,48,12,3,Office Supplies,Art,21,36,36
AZ-2013-7228854,91,3,2,Office Supplies,Art,88,88,6
AZ-2013-7228854,186,58,5,Office Supplies,Binders,59,128,290
AZ-2013-7228854,36,7,1,Technology,Accessories,29,29,7
AZ-2013-7261942,497,169,4,Technology,Copiers,328,328,676
AZ-2013-7283471,107,9,2,Office Supplies,Art,98,98,18
AZ-2013-7287311,708,184,5,Office Supplies,Storage,524,524,920
AZ-2013-7290380,25,3,3,Office Supplies,Storage,22,22,9
AZ-2013-7291240,776,186,4,Furniture,Bookcases,590,590,744
AZ-2013-7300382,32,2,2,Office Supplies,Envelopes,30,30,4
AZ-2013-7300382,490,39,4,Technology,Copiers,451,451,156
AZ-2013-7312557,53,15,2,Office Supplies,Art,38,38,30
AZ-2013-7312978,146,63,3,Office Supplies,Art,83,83,189
AZ-2013-7312978,43,21,3,Office Supplies,Fasteners,22,22,63
AZ-2013-7317179,324,10,2,Furniture,Chairs,314,314,20
AZ-2013-7317179,123,49,6,Office Supplies,Envelopes,74,74,294
AZ-2013-7321100,217,4,2,Furniture,Furnishings,213,213,8
AZ-2013-7321100,3220,966,5,Technology,Phones,2254,2254,4830
AZ-2013-7322131,16,0,2,Office Supplies,Binders,16,16,0
AZ-2013-7322131,122,14,7,Office Supplies,Storage,108,108,98
AZ-2013-7342591,117,51,2,Office Supplies,Appliances,66,66,102
AZ-2013-7342591,31,2,2,Office Supplies,Binders,29,29,4
AZ-2013-7342591,87,4,2,Office Supplies,Supplies,83,83,8
AZ-2013-7342591,173,86,1,Technology,Copiers,87,87,86
AZ-2013-7356315,389,85,2,Technology,Copiers,304,304,170
AZ-2013-7367497,155,69,3,Office Supplies,Storage,86,86,207
AZ-2013-7378404,541,49,2,Furniture,Tables,492,492,98
AZ-2013-739088,214,105,7,Office Supplies,Envelopes,109,109,735
AZ-2013-739088,1156,231,10,Office Supplies,Storage,925,925,2310
AZ-2013-7396799,814,96,5,Technology,Copiers,718,718,480
AZ-2013-7396799,215,71,1,Technology,Machines,144,144,71
AZ-2013-7397368,308,100,6,Furniture,Chairs,208,208,600
AZ-2013-7397368,81,22,1,Technology,Phones,59,59,22
AZ-2013-7409274,224,105,2,Technology,Accessories,119,119,210
AZ-2013-7409274,769,169,3,Technology,Machines,600,600,507
AZ-2013-7420821,57,20,4,Office Supplies,Binders,19,37,80
AZ-2013-7421576,201,76,4,Furniture,Furnishings,125,125,304
AZ-2013-7431618,263,15,2,Furniture,Bookcases,248,248,30
AZ-2013-7431618,43,21,3,Office Supplies,Supplies,22,22,63
AZ-2013-7432125,338,13,7,Office Supplies,Paper,325,325,91
AZ-2013-7436115,332,119,7,Office Supplies,Envelopes,213,213,833
AZ-2013-7442284,99,11,2,Office Supplies,Binders,88,88,22
AZ-2013-7442284,323,71,7,Office Supplies,Supplies,252,252,497
AZ-2013-7453439,115,6,2,Furniture,Chairs,109,109,12
AZ-2013-7453439,427,108,10,Office Supplies,Art,240,319,1080
AZ-2013-7453439,41,20,3,Office Supplies,Fasteners,21,21,60
AZ-2013-7462248,29,6,2,Office Supplies,Art,23,23,12
AZ-2013-7462248,76,2,5,Office Supplies,Supplies,74,74,10
AZ-2013-7527034,442,74,3,Technology,Machines,368,368,222
AZ-2013-7533368,496,175,4,Technology,Phones,321,321,700
AZ-2013-7542722,79,-6,6,Office Supplies,Envelopes,60,85,-36
AZ-2013-7542722,264,-132,2,Technology,Copiers,396,396,-264
AZ-2013-7542722,354,-249,9,Technology,Phones,131,603,-2241
AZ-2013-7546171,95,30,4,Furniture,Furnishings,65,65,120
AZ-2013-755831,40,13,3,Office Supplies,Paper,27,27,39
AZ-2013-755831,716,101,5,Technology,Machines,615,615,505
AZ-2013-7570613,222,104,2,Furniture,Furnishings,118,118,208
AZ-2013-7570613,67,29,1,Technology,Phones,38,38,29
AZ-2013-7581028,462,92,4,Office Supplies,Storage,370,370,368
AZ-2013-7588631,16,2,4,Office Supplies,Binders,14,14,8
AZ-2013-7588631,72,3,6,Office Supplies,Labels,69,69,18
AZ-2013-7597474,283,93,14,Office Supplies,Art,190,190,1302
AZ-2013-7597474,18,7,2,Office Supplies,Fasteners,11,11,14
AZ-2013-7600206,91,41,7,Office Supplies,Fasteners,50,50,287
AZ-2013-7607694,165,30,3,Office Supplies,Art,135,135,90
AZ-2013-7607694,20,5,3,Office Supplies,Binders,15,15,15
AZ-2013-7626927,602,114,12,Furniture,Furnishings,488,488,1368
AZ-2013-7626927,648,0,13,Office Supplies,Art,648,648,0
AZ-2013-7626927,34,9,3,Office Supplies,Binders,25,25,27
AZ-2013-7626927,734,86,7,Technology,Phones,648,648,602
AZ-2013-764808,50,-25,2,Office Supplies,Storage,75,75,-50
AZ-2013-7662993,795,270,3,Technology,Copiers,525,525,810
AZ-2013-7684337,164,54,6,Office Supplies,Envelopes,110,110,324
AZ-2013-7691747,1856,910,6,Office Supplies,Appliances,946,946,5460
AZ-2013-7691747,77,1,2,Office Supplies,Envelopes,76,76,2
AZ-2013-7698467,42,16,5,Office Supplies,Labels,26,26,80
AZ-2013-7698467,230,53,4,Technology,Accessories,177,177,212
AZ-2013-7698467,662,-386,8,Technology,Phones,1048,1048,-3088
AZ-2013-7710840,30,11,2,Office Supplies,Art,19,19,22
AZ-2013-7710840,11,2,1,Office Supplies,Binders,9,9,2
AZ-2013-7719706,176,79,4,Office Supplies,Envelopes,97,97,316
AZ-2013-7720719,56,27,8,Office Supplies,Binders,29,29,216
AZ-2013-7720719,119,45,3,Office Supplies,Envelopes,74,74,135
AZ-2013-7720719,781,141,3,Technology,Copiers,640,640,423
AZ-2013-7722338,19,1,3,Office Supplies,Binders,18,18,3
AZ-2013-7735459,73,25,5,Office Supplies,Envelopes,48,48,125
AZ-2013-7749449,98,21,3,Office Supplies,Paper,77,77,63
AZ-2013-7764209,345,107,2,Furniture,Bookcases,238,238,214
AZ-2013-7764209,64,13,6,Office Supplies,Binders,28,51,78
AZ-2013-7764209,60,-26,2,Technology,Machines,86,86,-52
AZ-2013-7788817,151,9,3,Office Supplies,Binders,142,142,27
AZ-2013-7788817,238,31,5,Office Supplies,Storage,207,207,155
AZ-2013-7816425,348,74,13,Office Supplies,Binders,62,274,962
AZ-2013-7868925,39,11,2,Office Supplies,Paper,28,28,22
AZ-2013-7868925,122,32,1,Technology,Copiers,90,90,32
AZ-2013-7897530,65,17,2,Office Supplies,Paper,48,48,34
AZ-2013-7897530,1524,-51,8,Office Supplies,Storage,1575,1575,-408
AZ-2013-7902577,1172,322,5,Furniture,Bookcases,335,850,1610
AZ-2013-7902577,59,27,2,Office Supplies,Paper,32,32,54
AZ-2013-7902577,226,14,6,Office Supplies,Supplies,212,212,84
AZ-2013-7902577,859,43,6,Technology,Phones,816,816,258
AZ-2013-7903596,536,232,3,Office Supplies,Storage,304,304,696
AZ-2013-7918506,27,5,2,Office Supplies,Labels,22,22,10
AZ-2013-7922182,341,31,2,Furniture,Bookcases,310,310,62
AZ-2013-7943122,96,-103,3,Furniture,Chairs,199,199,-309
AZ-2013-7944566,44,11,1,Office Supplies,Storage,33,33,11
AZ-2013-7944566,392,149,6,Technology,Phones,243,243,894
AZ-2013-796165,58,3,3,Office Supplies,Envelopes,55,55,9
AZ-2013-7969645,166,53,4,Technology,Accessories,113,113,212
AZ-2013-7980610,520,203,3,Technology,Phones,317,317,609
AZ-2013-7982799,215,-247,2,Furniture,Tables,462,462,-494
AZ-2013-7982799,191,32,7,Office Supplies,Art,159,159,224
AZ-2013-7994697,31,5,2,Office Supplies,Art,26,26,10
AZ-2013-7994697,954,219,3,Technology,Copiers,735,735,657
AZ-2013-8017533,198,41,7,Office Supplies,Binders,157,157,287
AZ-2013-8017533,469,182,4,Technology,Phones,287,287,728
AZ-2013-8019814,286,114,2,Technology,Phones,172,172,228
AZ-2013-8044431,79,16,2,Furniture,Furnishings,63,63,32
AZ-2013-8046606,24,2,1,Furniture,Furnishings,22,22,2
AZ-2013-8046606,34,3,3,Office Supplies,Art,31,31,9
AZ-2013-8046606,41,11,6,Office Supplies,Binders,30,30,66
AZ-2013-8046606,80,22,5,Office Supplies,Fasteners,58,58,110
AZ-2013-8046606,69,31,11,Office Supplies,Labels,8,38,341
AZ-2013-8046606,214,30,3,Technology,Accessories,184,184,90
AZ-2013-8046606,1842,-68,7,Technology,Machines,1097,1910,-476
AZ-2013-8046606,116,48,2,Technology,Phones,68,68,96
AZ-2013-8057502,1580,32,6,Technology,Copiers,1548,1548,192
AZ-2013-8064261,189,40,4,Furniture,Furnishings,149,149,160
AZ-2013-8064261,3979,1990,7,Office Supplies,Appliances,1989,1989,13930
AZ-2013-8073030,45,8,5,Office Supplies,Binders,37,37,40
AZ-2013-8089824,75,5,2,Office Supplies,Supplies,70,70,10
AZ-2013-8090289,414,115,1,Furniture,Chairs,299,299,115
AZ-2013-8108569,135,62,5,Office Supplies,Art,73,73,310
AZ-2013-8122695,2594,1141,5,Office Supplies,Appliances,1453,1453,5705
AZ-2013-8122695,342,41,7,Office Supplies,Binders,301,301,287
AZ-2013-8131512,102,22,7,Office Supplies,Art,80,80,154
AZ-2013-8139243,104,19,2,Office Supplies,Binders,85,85,38
AZ-2013-8139243,57,27,2,Office Supplies,Supplies,30,30,54
AZ-2013-8158326,137,48,2,Office Supplies,Appliances,89,89,96
AZ-2013-8158326,743,349,3,Technology,Accessories,394,394,1047
AZ-2013-8159608,344,10,5,Office Supplies,Appliances,334,334,50
AZ-2013-8159608,29,1,1,Office Supplies,Art,28,28,1
AZ-2013-8159608,14,3,1,Office Supplies,Binders,11,11,3
AZ-2013-8159608,206,27,7,Technology,Accessories,179,179,189
AZ-2013-8161791,336,112,6,Office Supplies,Storage,224,224,672
AZ-2013-8194857,170,51,2,Office Supplies,Appliances,119,119,102
AZ-2013-8194857,237,47,9,Office Supplies,Paper,190,190,423
AZ-2013-8207350,936,103,7,Furniture,Chairs,833,833,721
AZ-2013-8207350,40,18,3,Office Supplies,Paper,22,22,54
AZ-2013-8213331,108,54,4,Office Supplies,Art,54,54,216
AZ-2013-8213331,10,3,2,Office Supplies,Labels,7,7,6
AZ-2013-8213331,174,33,4,Office Supplies,Storage,141,141,132
AZ-2013-8218770,55,4,2,Office Supplies,Art,51,51,8
AZ-2013-8231031,40,13,2,Office Supplies,Art,27,27,26
AZ-2013-8231031,765,-179,9,Office Supplies,Storage,944,944,-1611
AZ-2013-8231031,54,5,2,Technology,Accessories,49,49,10
AZ-2013-8255562,30,12,1,Office Supplies,Binders,18,18,12
AZ-2013-82677,47,1,2,Office Supplies,Art,46,46,2
AZ-2013-82677,293,0,7,Technology,Accessories,293,293,0
AZ-2013-8277414,106,30,4,Furniture,Furnishings,76,76,120
AZ-2013-8277414,71,6,4,Office Supplies,Art,65,65,24
AZ-2013-8287659,37,9,3,Office Supplies,Labels,28,28,27
AZ-2013-8287659,68,7,2,Office Supplies,Paper,61,61,14
AZ-2013-8301856,676,30,5,Technology,Copiers,646,646,150
AZ-2013-8343669,156,24,3,Office Supplies,Storage,132,132,72
AZ-2013-8348000,374,42,3,Furniture,Chairs,332,332,126
AZ-2013-8348000,8,1,2,Office Supplies,Binders,7,7,2
AZ-2013-8348000,42,17,2,Office Supplies,Paper,25,25,34
AZ-2013-8348952,1275,140,2,Technology,Phones,1135,1135,280
AZ-2013-8354954,249,12,4,Office Supplies,Storage,237,237,48
AZ-2013-8360642,38,6,2,Furniture,Furnishings,32,32,12
AZ-2013-8360642,137,-6,1,Technology,Machines,143,143,-6
AZ-2013-8360642,1623,134,3,Technology,Phones,1489,1489,402
AZ-2013-8362803,24,8,4,Office Supplies,Binders,16,16,32
AZ-2013-8367272,582,174,5,Technology,Accessories,408,408,870
AZ-2013-8369315,38,1,3,Office Supplies,Labels,37,37,3
AZ-2013-8382416,29,-3,2,Office Supplies,Binders,32,32,-6
AZ-2013-8383284,260,57,5,Furniture,Furnishings,203,203,285
AZ-2013-842018,1334,531,11,Furniture,Bookcases,242,803,5841
AZ-2013-8435780,410,37,3,Technology,Phones,373,373,111
AZ-2013-8443460,68,29,4,Office Supplies,Art,39,39,116
AZ-2013-8445790,164,78,3,Office Supplies,Art,86,86,234
AZ-2013-8445790,206,97,10,Office Supplies,Paper,109,109,970
AZ-2013-8455178,124,62,1,Furniture,Bookcases,62,62,62
AZ-2013-8455178,245,64,2,Technology,Copiers,181,181,128
AZ-2013-8471021,81,41,3,Office Supplies,Art,40,40,123
AZ-2013-8471021,11,4,1,Office Supplies,Binders,7,7,4
AZ-2013-8477787,84,30,5,Office Supplies,Art,54,54,150
AZ-2013-8483986,116,13,4,Office Supplies,Art,103,103,52
AZ-2013-8489982,216,47,4,Furniture,Chairs,169,169,188
AZ-2013-8489982,44,14,5,Office Supplies,Labels,30,30,70
AZ-2013-8493783,255,74,5,Office Supplies,Binders,181,181,370
AZ-2013-8493783,964,231,5,Technology,Copiers,733,733,1155
AZ-2013-8513388,450,190,4,Furniture,Bookcases,260,260,760
AZ-2013-8513388,101,2,2,Furniture,Furnishings,99,99,4
AZ-2013-8513388,97,36,7,Office Supplies,Binders,61,61,252
AZ-2013-8513388,6,1,1,Office Supplies,Envelopes,5,5,1
AZ-2013-8513388,498,179,2,Technology,Accessories,319,319,358
AZ-2013-8560588,95,42,4,Office Supplies,Storage,53,53,168
AZ-2013-8568485,45,5,3,Office Supplies,Binders,40,40,15
AZ-2013-8568485,210,-30,2,Technology,Phones,240,240,-60
AZ-2013-8583368,303,33,6,Office Supplies,Binders,270,270,198
AZ-2013-8583368,612,187,2,Technology,Copiers,425,425,374
AZ-2013-8597747,17,8,1,Furniture,Furnishings,9,9,8
AZ-2013-8602131,495,163,10,Office Supplies,Binders,95,332,1630
AZ-2013-8602131,25,10,3,Office Supplies,Fasteners,15,15,30
AZ-2013-8603182,221,-22,2,Furniture,Bookcases,243,243,-44
AZ-2013-8603182,52,21,2,Office Supplies,Envelopes,31,31,42
AZ-2013-860383,64,24,4,Office Supplies,Art,40,40,96
AZ-2013-860383,105,28,2,Office Supplies,Paper,77,77,56
AZ-2013-8607757,26,11,2,Office Supplies,Binders,15,15,22
AZ-2013-8614135,19,8,1,Furniture,Furnishings,11,11,8
AZ-2013-8617478,225,68,4,Furniture,Chairs,157,157,272
AZ-2013-8617478,11,2,1,Office Supplies,Labels,9,9,2
AZ-2013-8620974,204,53,1,Office Supplies,Storage,151,151,53
AZ-2013-8622120,470,73,9,Furniture,Chairs,397,397,657
AZ-2013-8622120,1015,-500,3,Furniture,Tables,1515,1515,-1500
AZ-2013-8622120,43,9,3,Office Supplies,Fasteners,34,34,27
AZ-2013-8622120,21,4,2,Office Supplies,Labels,17,17,8
AZ-2013-8622401,172,48,2,Office Supplies,Appliances,124,124,96
AZ-2013-8624401,30,5,5,Office Supplies,Binders,25,25,25
AZ-2013-8629529,1533,-34,3,Office Supplies,Appliances,1567,1567,-102
AZ-2013-8629529,130,52,3,Office Supplies,Storage,78,78,156
AZ-2013-8633659,264,95,6,Furniture,Furnishings,169,169,570
AZ-2013-8633659,150,0,3,Office Supplies,Art,150,150,0
AZ-2013-8635994,138,36,3,Furniture,Chairs,102,102,108
AZ-2013-8635994,149,49,3,Office Supplies,Art,100,100,147
AZ-2013-8635994,35,6,7,Office Supplies,Labels,29,29,42
AZ-2013-8659278,41,20,1,Technology,Accessories,21,21,20
AZ-2013-8665589,1567,360,8,Furniture,Bookcases,1207,1207,2880
AZ-2013-8667063,409,143,3,Furniture,Chairs,266,266,429
AZ-2013-8667063,48,13,2,Furniture,Furnishings,35,35,26
AZ-2013-8667063,161,40,3,Office Supplies,Art,121,121,120
AZ-2013-8667063,34,9,3,Office Supplies,Binders,25,25,27
AZ-2013-8667063,1026,482,4,Technology,Accessories,544,544,1928
AZ-2013-8667063,2880,1296,9,Technology,Copiers,1584,1584,11664
AZ-2013-866971,2476,1015,6,Furniture,Bookcases,1461,1461,6090
AZ-2013-866971,58,19,4,Office Supplies,Art,39,39,76
AZ-2013-8670779,20,8,1,Office Supplies,Art,12,12,8
AZ-2013-8676684,163,37,6,Technology,Accessories,126,126,222
AZ-2013-8689698,385,35,8,Office Supplies,Supplies,350,350,280
AZ-2013-8712003,172,54,10,Office Supplies,Paper,69,118,540
AZ-2013-8717132,229,51,3,Office Supplies,Appliances,178,178,153
AZ-2013-8732782,534,5,2,Technology,Machines,529,529,10
AZ-2013-8748241,23,-6,4,Office Supplies,Binders,29,29,-24
AZ-2013-8751225,184,59,3,Furniture,Chairs,125,125,177
AZ-2013-8751225,46,9,4,Office Supplies,Labels,37,37,36
AZ-2013-8751225,187,77,9,Office Supplies,Paper,110,110,693
AZ-2013-8751225,76,7,3,Office Supplies,Supplies,69,69,21
AZ-2013-8751225,312,51,3,Technology,Machines,261,261,153
AZ-2013-8751225,721,34,5,Technology,Phones,687,687,170
AZ-2013-8774500,1243,345,3,Furniture,Chairs,898,898,1035
AZ-2013-8774500,53,3,3,Office Supplies,Storage,50,50,9
AZ-2013-8774500,1244,448,5,Technology,Accessories,796,796,2240
AZ-2013-8795323,58,15,9,Office Supplies,Binders,43,43,135
AZ-2013-8795323,393,131,9,Technology,Accessories,58,262,1179
AZ-2013-8803933,22,8,2,Office Supplies,Fasteners,14,14,16
AZ-2013-8803933,542,65,13,Office Supplies,Supplies,477,477,845
AZ-2013-881740,98,28,2,Office Supplies,Art,70,70,56
AZ-2013-881740,226,56,4,Office Supplies,Storage,170,170,224
AZ-2013-8831397,1064,225,7,Furniture,Bookcases,839,839,1575
AZ-2013-8831397,246,34,6,Furniture,Furnishings,212,212,204
AZ-2013-8831397,224,-12,4,Office Supplies,Storage,236,236,-48
AZ-2013-8838636,84,34,3,Office Supplies,Supplies,50,50,102
AZ-2013-885616,714,-179,10,Furniture,Chairs,893,893,-1790
AZ-2013-885616,1231,468,5,Technology,Accessories,763,763,2340
AZ-2013-8859377,14,7,1,Office Supplies,Fasteners,7,7,7
AZ-2013-8859377,420,159,8,Office Supplies,Storage,261,261,1272
AZ-2013-8862590,1211,137,9,Furniture,Bookcases,304,1074,1233
AZ-2013-8862590,38,6,2,Furniture,Furnishings,32,32,12
AZ-2013-8862590,430,97,9,Office Supplies,Art,178,333,873
AZ-2013-8862590,67,7,3,Office Supplies,Envelopes,60,60,21
AZ-2013-8862590,34,0,3,Office Supplies,Fasteners,34,34,0
AZ-2013-8862590,1086,268,2,Technology,Phones,818,818,536
AZ-2013-8869856,10,2,1,Office Supplies,Storage,8,8,2
AZ-2013-8882411,1998,360,4,Office Supplies,Appliances,1638,1638,1440
AZ-2013-8882411,110,38,2,Office Supplies,Art,72,72,76
AZ-2013-8886888,89,31,3,Office Supplies,Art,58,58,93
AZ-2013-890356,123,56,4,Office Supplies,Paper,67,67,224
AZ-2013-890356,1239,582,5,Technology,Accessories,657,657,2910
AZ-2013-8946887,80,29,7,Office Supplies,Labels,51,51,203
AZ-2013-8948027,157,41,6,Office Supplies,Art,116,116,246
AZ-2013-8948027,417,175,5,Technology,Machines,242,242,875
AZ-2013-8949269,21,5,2,Office Supplies,Binders,16,16,10
AZ-2013-8958085,529,176,12,Office Supplies,Art,334,353,2112
AZ-2013-8958085,133,37,8,Office Supplies,Binders,96,96,296
AZ-2013-8958085,69,16,6,Office Supplies,Labels,53,53,96
AZ-2013-8958085,488,-73,4,Office Supplies,Storage,561,561,-292
AZ-2013-8958085,89,5,4,Office Supplies,Supplies,84,84,20
AZ-2013-8958085,1020,63,4,Technology,Copiers,241,957,252
AZ-2013-8981148,258,44,5,Office Supplies,Art,214,214,220
AZ-2013-8987528,190,32,1,Office Supplies,Storage,158,158,32
AZ-2013-9000546,321,132,3,Furniture,Furnishings,189,189,396
AZ-2013-9000546,1124,125,4,Technology,Machines,999,999,500
AZ-2013-9006218,771,163,6,Furniture,Bookcases,608,608,978
AZ-2013-9006218,49,9,5,Office Supplies,Storage,40,40,45
AZ-2013-9006218,1842,647,15,Technology,Phones,121,1195,9705
AZ-2013-9011810,48,3,3,Office Supplies,Envelopes,45,45,9
AZ-2013-9012669,215,17,3,Furniture,Chairs,198,198,51
AZ-2013-9012669,28,11,1,Office Supplies,Supplies,17,17,11
AZ-2013-9033222,106,49,2,Office Supplies,Binders,57,57,98
AZ-2013-9033222,53,6,2,Office Supplies,Envelopes,47,47,12
AZ-2013-9033222,131,54,3,Office Supplies,Storage,77,77,162
AZ-2013-9057742,82,23,3,Office Supplies,Binders,59,59,69
AZ-2013-9061739,246,74,8,Technology,Accessories,172,172,592
AZ-2013-906289,321,35,2,Technology,Machines,286,286,70
AZ-2013-9065398,345,0,3,Technology,Accessories,345,345,0
AZ-2013-9067941,657,118,5,Furniture,Chairs,539,539,590
AZ-2013-9067941,83,30,6,Office Supplies,Binders,25,53,180
AZ-2013-9067941,66,3,9,Office Supplies,Labels,63,63,27
AZ-2013-9080857,106,18,7,Office Supplies,Paper,88,88,126
AZ-2013-9091155,46,8,3,Office Supplies,Art,38,38,24
AZ-2013-9091155,56,17,2,Office Supplies,Paper,39,39,34
AZ-2013-9134300,259,39,5,Office Supplies,Art,220,220,195
AZ-2013-9134300,14,1,2,Office Supplies,Labels,13,13,2
AZ-2013-9134300,27,8,2,Office Supplies,Paper,19,19,16
AZ-2013-9134300,29,-13,2,Office Supplies,Storage,42,42,-26
AZ-2013-9134300,306,-31,3,Technology,Machines,337,337,-93
AZ-2013-9144577,381,19,13,Office Supplies,Art,362,362,247
AZ-2013-9144577,97,0,2,Office Supplies,Supplies,97,97,0
AZ-2013-9151069,25,9,3,Office Supplies,Binders,16,16,27
AZ-2013-9167748,73,25,5,Office Supplies,Envelopes,48,48,125
AZ-2013-9185602,62,6,5,Office Supplies,Binders,56,56,30
AZ-2013-9186564,2712,1220,5,Office Supplies,Appliances,1492,1492,6100
AZ-2013-9188283,131,34,5,Office Supplies,Art,97,97,170
AZ-2013-9221465,269,21,5,Office Supplies,Art,248,248,105
AZ-2013-9221465,53,7,4,Office Supplies,Storage,46,46,28
AZ-2013-9221465,92,39,3,Technology,Accessories,53,53,117
AZ-2013-9221465,950,114,3,Technology,Copiers,836,836,342
AZ-2013-9221465,2684,-1476,7,Technology,Phones,4160,4160,-10332
AZ-2013-9231004,45,4,3,Office Supplies,Binders,41,41,12
AZ-2013-9251639,97,4,2,Office Supplies,Paper,93,93,8
AZ-2013-9258078,24,-24,4,Office Supplies,Art,48,48,-96
AZ-2013-9263233,410,14,1,Furniture,Chairs,396,396,14
AZ-2013-9280620,53,16,3,Office Supplies,Storage,37,37,48
AZ-2013-9280620,910,200,5,Technology,Phones,710,710,1000
AZ-2013-9283365,2753,842,9,Technology,Copiers,1911,1911,7578
AZ-2013-9304713,138,23,4,Office Supplies,Storage,115,115,92
AZ-2013-9306812,68,33,6,Office Supplies,Fasteners,35,35,198
AZ-2013-9330718,415,17,3,Technology,Phones,398,398,51
AZ-2013-9345713,395,32,8,Office Supplies,Binders,215,363,256
AZ-2013-9345713,165,39,3,Office Supplies,Storage,126,126,117
AZ-2013-9347181,141,27,6,Office Supplies,Envelopes,114,114,162
AZ-2013-9347181,332,53,4,Technology,Accessories,279,279,212
AZ-2013-9352231,42,15,3,Office Supplies,Binders,27,27,45
AZ-2013-9354071,62,17,2,Technology,Accessories,45,45,34
AZ-2013-9354071,111,-14,2,Technology,Phones,125,125,-28
AZ-2013-9381162,150,0,3,Office Supplies,Art,150,150,0
AZ-2013-9381162,84,20,5,Office Supplies,Envelopes,32,64,100
AZ-2013-9381162,42,17,3,Office Supplies,Storage,25,25,51
AZ-2013-9393754,192,-123,3,Office Supplies,Storage,315,315,-369
AZ-2013-9393754,103,-2,5,Office Supplies,Supplies,105,105,-10
AZ-2013-9393754,431,-103,5,Technology,Machines,534,534,-515
AZ-2013-9398373,61,8,4,Office Supplies,Binders,53,53,32
AZ-2013-9398373,89,6,3,Technology,Accessories,83,83,18
AZ-2013-9398521,71,1,3,Office Supplies,Art,70,70,3
AZ-2013-9398521,108,30,7,Office Supplies,Binders,78,78,210
AZ-2013-9453292,261,99,4,Office Supplies,Appliances,162,162,396
AZ-2013-9453292,615,25,5,Technology,Machines,590,590,125
AZ-2013-9485550,99,8,3,Furniture,Furnishings,91,91,24
AZ-2013-9485550,278,14,1,Office Supplies,Appliances,264,264,14
AZ-2013-9489930,5,2,1,Office Supplies,Labels,3,3,2
AZ-2013-9496816,397,194,2,Office Supplies,Storage,203,203,388
AZ-2013-9502186,28,14,4,Office Supplies,Binders,14,14,56
AZ-2013-9510969,1691,-833,5,Furniture,Tables,2524,2524,-4165
AZ-2013-9510969,415,62,8,Office Supplies,Art,353,353,496
AZ-2013-9510969,29,10,2,Office Supplies,Binders,19,19,20
AZ-2013-9510969,41,13,2,Office Supplies,Paper,28,28,26
AZ-2013-9517506,757,371,2,Technology,Copiers,386,386,742
AZ-2013-9532879,912,55,6,Technology,Phones,857,857,330
AZ-2013-9545933,34,8,3,Office Supplies,Art,26,26,24
AZ-2013-9549607,585,147,7,Furniture,Furnishings,299,438,1029
AZ-2013-9549607,44,14,4,Office Supplies,Binders,30,30,56
AZ-2013-9561229,150,5,1,Furniture,Chairs,145,145,5
AZ-2013-9571579,57,17,2,Office Supplies,Binders,40,40,34
AZ-2013-9571579,232,23,5,Office Supplies,Envelopes,209,209,115
AZ-2013-9573927,311,-292,2,Office Supplies,Appliances,603,603,-584
AZ-2013-9588348,196,27,4,Furniture,Furnishings,169,169,108
AZ-2013-9591675,165,43,5,Furniture,Furnishings,85,122,215
AZ-2013-9591675,41,16,3,Office Supplies,Fasteners,25,25,48
AZ-2013-9606437,16,1,1,Office Supplies,Art,15,15,1
AZ-2013-9611226,279,70,2,Technology,Phones,209,209,140
AZ-2013-9616659,412,148,3,Furniture,Chairs,264,264,444
AZ-2013-962697,283,42,4,Technology,Machines,241,241,168
AZ-2013-9630645,74,-63,4,Furniture,Chairs,137,137,-252
AZ-2013-9630645,42,15,3,Office Supplies,Binders,27,27,45
AZ-2013-9630645,67,16,5,Office Supplies,Fasteners,51,51,80
AZ-2013-9630645,58,-8,2,Office Supplies,Storage,66,66,-16
AZ-2013-9630645,69,0,2,Office Supplies,Supplies,69,69,0
AZ-2013-9649532,697,178,2,Furniture,Bookcases,519,519,356
AZ-2013-9649532,64,24,2,Office Supplies,Art,40,40,48
AZ-2013-9649532,325,-4,2,Technology,Copiers,329,329,-8
AZ-2013-9663287,837,288,2,Furniture,Chairs,549,549,576
AZ-2013-9663287,88,22,2,Office Supplies,Storage,66,66,44
AZ-2013-9665957,265,13,2,Technology,Phones,252,252,26
AZ-2013-9667532,57,20,2,Office Supplies,Binders,37,37,40
AZ-2013-9673280,186,28,4,Office Supplies,Art,158,158,112
AZ-2013-9717790,148,15,2,Technology,Accessories,133,133,30
AZ-2013-9718437,1488,132,4,Furniture,Bookcases,1356,1356,528
AZ-2013-971860,98,39,4,Office Supplies,Art,59,59,156
AZ-2013-972809,156,23,3,Office Supplies,Art,133,133,69
AZ-2013-972809,31,-15,3,Office Supplies,Storage,46,46,-45
AZ-2013-9730235,75,5,3,Office Supplies,Art,70,70,15
AZ-2013-9730235,220,33,3,Technology,Phones,187,187,99
AZ-2013-9746580,135,12,1,Furniture,Bookcases,123,123,12
AZ-2013-9746580,680,60,9,Furniture,Chairs,620,620,540
AZ-2013-9757987,19,9,1,Office Supplies,Fasteners,10,10,9
AZ-2013-9757987,89,23,3,Office Supplies,Paper,66,66,69
AZ-2013-9757987,573,138,3,Technology,Copiers,435,435,414
AZ-2013-9761394,5274,1898,10,Office Supplies,Appliances,3376,3376,18980
AZ-2013-9761394,1429,472,4,Technology,Copiers,957,957,1888
AZ-2013-9773289,58,13,3,Office Supplies,Art,45,45,39
AZ-2013-9777837,120,3,4,Office Supplies,Paper,117,117,12
AZ-2013-9800622,228,81,2,Furniture,Bookcases,147,147,162
AZ-2013-9800622,126,22,9,Office Supplies,Binders,49,104,198
AZ-2013-9800622,1842,368,10,Office Supplies,Storage,1474,1474,3680
AZ-2013-9800622,340,51,5,Technology,Phones,289,289,255
AZ-2013-9809267,123,17,3,Furniture,Furnishings,106,106,51
AZ-2013-9809267,203,7,9,Office Supplies,Art,12,196,63
AZ-2013-9809267,123,17,9,Office Supplies,Binders,106,106,153
AZ-2013-9809267,246,0,5,Office Supplies,Storage,246,246,0
AZ-2013-9827479,105,19,2,Office Supplies,Paper,86,86,38
AZ-2013-9842904,38,14,2,Office Supplies,Art,24,24,28
AZ-2013-9861986,249,30,5,Office Supplies,Paper,219,219,150
AZ-2013-9877941,100,0,2,Office Supplies,Art,100,100,0
AZ-2013-9877941,143,14,5,Office Supplies,Paper,129,129,70
AZ-2013-9884020,256,90,5,Office Supplies,Binders,166,166,450
AZ-2013-989352,22,0,1,Office Supplies,Art,22,22,0
AZ-2013-9900662,180,34,6,Office Supplies,Supplies,146,146,204
AZ-2013-990166,150,32,3,Office Supplies,Binders,118,118,96
AZ-2013-9907,50,19,2,Furniture,Furnishings,31,31,38
AZ-2013-9907,93,18,4,Office Supplies,Art,75,75,72
AZ-2013-9907,132,59,3,Office Supplies,Envelopes,73,73,177
AZ-2013-9918449,15,4,3,Office Supplies,Binders,11,11,12
AZ-2013-9918449,184,33,1,Office Supplies,Storage,151,151,33
AZ-2013-9938365,101,31,2,Furniture,Furnishings,70,70,62
AZ-2013-9969436,121,56,4,Office Supplies,Binders,65,65,224
AZ-2013-997141,112,40,4,Office Supplies,Paper,72,72,160
AZ-2013-997141,423,186,2,Office Supplies,Storage,237,237,372
AZ-2013-9992531,137,46,2,Furniture,Chairs,91,91,92
AZ-2013-9992531,386,-26,6,Technology,Accessories,412,412,-156
AZ-2014-1007120,1232,530,3,Furniture,Bookcases,702,702,1590
AZ-2014-1007120,990,436,9,Furniture,Furnishings,554,554,3924
AZ-2014-1020342,430,139,16,Office Supplies,Art,169,291,2224
AZ-2014-1020342,18,1,3,Office Supplies,Binders,17,17,3
AZ-2014-1020342,44,10,1,Office Supplies,Storage,34,34,10
AZ-2014-1020342,1190,405,7,Technology,Machines,785,785,2835
AZ-2014-1021956,194,46,7,Office Supplies,Storage,83,148,322
AZ-2014-1026568,48,-22,1,Furniture,Bookcases,70,70,-22
AZ-2014-1036259,97,13,2,Office Supplies,Storage,84,84,26
AZ-2014-1043314,48,6,2,Furniture,Furnishings,42,42,12
AZ-2014-1043314,29,1,2,Office Supplies,Binders,28,28,2
AZ-2014-1043314,22,3,2,Office Supplies,Labels,19,19,6
AZ-2014-1058854,553,110,3,Office Supplies,Storage,443,443,330
AZ-2014-1058907,40,-14,4,Office Supplies,Art,54,54,-56
AZ-2014-1058907,166,-70,5,Technology,Phones,236,236,-350
AZ-2014-1067698,1138,-643,10,Furniture,Bookcases,999,1781,-6430
AZ-2014-1067698,145,0,9,Office Supplies,Art,145,145,0
AZ-2014-1067698,158,-63,7,Office Supplies,Paper,221,221,-441
AZ-2014-1067698,398,-175,4,Office Supplies,Storage,573,573,-700
AZ-2014-1067698,108,-30,5,Technology,Accessories,138,138,-150
AZ-2014-1067698,264,-132,2,Technology,Copiers,396,396,-264
AZ-2014-1092001,2549,280,4,Technology,Phones,2269,2269,1120
AZ-2014-1092628,18,6,1,Office Supplies,Paper,12,12,6
AZ-2014-1092798,64,3,4,Office Supplies,Art,61,61,12
AZ-2014-1094147,102,13,2,Office Supplies,Art,89,89,26
AZ-2014-1094147,130,11,3,Office Supplies,Storage,119,119,33
AZ-2014-1101148,154,14,3,Office Supplies,Binders,140,140,42
AZ-2014-110527,854,196,7,Furniture,Bookcases,658,658,1372
AZ-2014-1111012,275,49,5,Office Supplies,Art,226,226,245
AZ-2014-1111012,52,11,5,Office Supplies,Fasteners,41,41,55
AZ-2014-1114768,32,12,2,Office Supplies,Art,20,20,24
AZ-2014-1114768,974,45,8,Office Supplies,Storage,210,929,360
AZ-2014-1127335,396,88,9,Office Supplies,Storage,308,308,792
AZ-2014-1127335,246,25,5,Office Supplies,Supplies,221,221,125
AZ-2014-1135927,132,26,5,Office Supplies,Paper,106,106,130
AZ-2014-1144428,211,57,8,Furniture,Furnishings,154,154,456
AZ-2014-115654,267,-40,2,Furniture,Chairs,307,307,-80
AZ-2014-115654,35,11,3,Office Supplies,Binders,24,24,33
AZ-2014-115654,332,100,2,Office Supplies,Storage,232,232,200
AZ-2014-115654,102,10,4,Technology,Accessories,92,92,40
AZ-2014-1173814,34,14,2,Office Supplies,Art,20,20,28
AZ-2014-1181661,36,15,3,Office Supplies,Art,21,21,45
AZ-2014-1191224,471,226,5,Furniture,Chairs,245,245,1130
AZ-2014-1191224,18,6,3,Office Supplies,Binders,12,12,18
AZ-2014-1191224,17,7,2,Office Supplies,Fasteners,10,10,14
AZ-2014-1191224,83,33,2,Technology,Accessories,50,50,66
AZ-2014-1191751,26,7,1,Office Supplies,Art,19,19,7
AZ-2014-1192603,120,44,6,Furniture,Furnishings,76,76,264
AZ-2014-1192603,52,-13,6,Office Supplies,Storage,65,65,-78
AZ-2014-1214037,158,62,4,Furniture,Furnishings,96,96,248
AZ-2014-1223291,530,238,2,Technology,Machines,292,292,476
AZ-2014-1235152,35,12,3,Office Supplies,Fasteners,23,23,36
AZ-2014-1239779,113,11,10,Office Supplies,Storage,102,102,110
AZ-2014-1240629,22,7,3,Office Supplies,Binders,15,15,21
AZ-2014-1240658,269,84,2,Furniture,Bookcases,185,185,168
AZ-2014-1240658,245,42,9,Office Supplies,Art,203,203,378
AZ-2014-1240658,157,59,3,Office Supplies,Storage,98,98,177
AZ-2014-1270889,423,5,1,Furniture,Chairs,418,418,5
AZ-2014-1270889,40,10,2,Office Supplies,Art,30,30,20
AZ-2014-1282413,273,8,6,Office Supplies,Art,265,265,48
AZ-2014-1290768,465,140,4,Technology,Accessories,325,325,560
AZ-2014-129299,689,96,6,Furniture,Furnishings,593,593,576
AZ-2014-1302174,1964,22,6,Furniture,Bookcases,1942,1942,132
AZ-2014-1308209,43,1,3,Office Supplies,Art,42,42,3
AZ-2014-1308209,809,296,7,Office Supplies,Storage,513,513,2072
AZ-2014-1314393,386,90,7,Office Supplies,Storage,296,296,630
AZ-2014-1317871,1136,91,2,Office Supplies,Appliances,1045,1045,182
AZ-2014-1320048,65,6,3,Office Supplies,Art,59,59,18
AZ-2014-1320048,15,3,1,Office Supplies,Envelopes,12,12,3
AZ-2014-1328396,527,-190,2,Office Supplies,Appliances,717,717,-380
AZ-2014-1332889,2020,707,12,Furniture,Bookcases,1313,1313,8484
AZ-2014-1343992,1113,297,3,Furniture,Bookcases,816,816,891
AZ-2014-13469,35,12,5,Office Supplies,Labels,23,23,60
AZ-2014-1353698,461,161,9,Office Supplies,Binders,300,300,1449
AZ-2014-1389011,260,-6,2,Furniture,Bookcases,266,266,-12
AZ-2014-1389011,42,16,3,Office Supplies,Fasteners,26,26,48
AZ-2014-1389011,98,21,3,Office Supplies,Paper,77,77,63
AZ-2014-1390032,283,80,7,Technology,Accessories,64,203,560
AZ-2014-139627,348,97,7,Office Supplies,Binders,251,251,679
AZ-2014-139627,146,22,7,Office Supplies,Paper,124,124,154
AZ-2014-139785,38,19,3,Office Supplies,Labels,19,19,57
AZ-2014-1406790,118,25,4,Technology,Accessories,93,93,100
AZ-2014-1412225,289,75,5,Office Supplies,Storage,214,214,375
AZ-2014-1447703,123,49,5,Office Supplies,Art,74,74,245
AZ-2014-1456061,158,65,5,Office Supplies,Binders,93,93,325
AZ-2014-1466197,267,74,3,Office Supplies,Appliances,193,193,222
AZ-2014-1466197,61,23,5,Office Supplies,Labels,38,38,115
AZ-2014-1466197,146,66,5,Technology,Accessories,80,80,330
AZ-2014-1466658,412,165,3,Office Supplies,Storage,247,247,495
AZ-2014-1466658,174,24,1,Technology,Machines,150,150,24
AZ-2014-1473813,283,-136,4,Office Supplies,Storage,419,419,-544
AZ-2014-1473888,133,1,2,Office Supplies,Appliances,132,132,2
AZ-2014-1473888,112,0,5,Office Supplies,Art,112,112,0
AZ-2014-1473888,48,1,2,Office Supplies,Storage,47,47,2
AZ-2014-1473888,520,151,3,Technology,Phones,369,369,453
AZ-2014-1474181,206,8,6,Office Supplies,Art,128,198,48
AZ-2014-1474181,45,1,4,Office Supplies,Binders,44,44,4
AZ-2014-1474181,56,5,7,Office Supplies,Labels,51,51,35
AZ-2014-1474181,113,23,6,Office Supplies,Paper,54,90,138
AZ-2014-1476167,62,9,2,Office Supplies,Storage,53,53,18
AZ-2014-1476767,11,2,1,Office Supplies,Labels,9,9,2
AZ-2014-1476767,218,46,3,Technology,Accessories,172,172,138
AZ-2014-1490273,448,-10,4,Furniture,Bookcases,458,458,-40
AZ-2014-1490273,44,8,2,Office Supplies,Art,36,36,16
AZ-2014-1490273,1280,299,7,Office Supplies,Storage,981,981,2093
AZ-2014-1499701,275,96,5,Office Supplies,Art,179,179,480
AZ-2014-1499701,42,12,5,Office Supplies,Binders,30,30,60
AZ-2014-1499701,893,387,5,Office Supplies,Storage,506,506,1935
AZ-2014-1499701,956,392,3,Technology,Copiers,564,564,1176
AZ-2014-1517512,46,20,5,Office Supplies,Labels,26,26,100
AZ-2014-1538782,860,-280,13,Office Supplies,Storage,63,1140,-3640
AZ-2014-1538782,251,4,3,Technology,Phones,247,247,12
AZ-2014-1538989,89,0,3,Office Supplies,Art,89,89,0
AZ-2014-1555448,98,30,2,Office Supplies,Storage,68,68,60
AZ-2014-1555562,339,109,8,Office Supplies,Storage,230,230,872
AZ-2014-1556718,2519,1033,7,Technology,Copiers,1486,1486,7231
AZ-2014-1568727,89,14,2,Office Supplies,Storage,75,75,28
AZ-2014-157670,68,27,1,Furniture,Chairs,41,41,27
AZ-2014-1586750,244,71,5,Office Supplies,Art,173,173,355
AZ-2014-1586750,21,5,2,Office Supplies,Storage,16,16,10
AZ-2014-1592554,316,104,7,Furniture,Chairs,212,212,728
AZ-2014-1592554,113,54,3,Office Supplies,Supplies,59,59,162
AZ-2014-1592554,82,7,1,Technology,Accessories,75,75,7
AZ-2014-1597164,102,13,2,Office Supplies,Art,89,89,26
AZ-2014-1598982,1591,541,6,Technology,Copiers,1050,1050,3246
AZ-2014-1612857,29,8,5,Office Supplies,Binders,21,21,40
AZ-2014-1612857,462,169,4,Office Supplies,Storage,293,293,676
AZ-2014-1612857,280,9,1,Technology,Machines,271,271,9
AZ-2014-1627847,114,48,4,Office Supplies,Paper,66,66,192
AZ-2014-1627961,29,1,3,Office Supplies,Labels,28,28,3
AZ-2014-1627961,230,20,2,Office Supplies,Storage,210,210,40
AZ-2014-1644192,335,110,4,Technology,Accessories,225,225,440
AZ-2014-1647261,76,14,3,Office Supplies,Envelopes,62,62,42
AZ-2014-1647261,68,33,5,Office Supplies,Fasteners,35,35,165
AZ-2014-165255,235,26,4,Technology,Accessories,209,209,104
AZ-2014-165255,249,60,2,Technology,Phones,189,189,120
AZ-2014-1661689,97,11,2,Office Supplies,Paper,86,86,22
AZ-2014-1661689,381,144,2,Office Supplies,Storage,237,237,288
AZ-2014-1665809,245,20,2,Technology,Copiers,225,225,40
AZ-2014-1665836,229,105,5,Office Supplies,Art,124,124,525
AZ-2014-1665836,138,3,2,Technology,Accessories,135,135,6
AZ-2014-1669266,776,-326,5,Technology,Machines,1102,1102,-1630
AZ-2014-1670847,578,231,4,Technology,Copiers,347,347,924
AZ-2014-167426,111,7,5,Office Supplies,Supplies,104,104,35
AZ-2014-168273,158,39,3,Furniture,Chairs,119,119,117
AZ-2014-1698292,79,32,3,Office Supplies,Art,47,47,96
AZ-2014-1698292,77,30,6,Office Supplies,Binders,47,47,180
AZ-2014-1698292,382,30,3,Office Supplies,Storage,352,352,90
AZ-2014-1698292,115,26,2,Technology,Accessories,89,89,52
AZ-2014-17071,355,31,3,Furniture,Chairs,324,324,93
AZ-2014-17071,22,1,1,Office Supplies,Supplies,21,21,1
AZ-2014-1723403,94,24,5,Office Supplies,Art,70,70,120
AZ-2014-1723403,65,28,4,Office Supplies,Envelopes,37,37,112
AZ-2014-1732557,16,-5,3,Office Supplies,Binders,21,21,-15
AZ-2014-175651,302,9,1,Technology,Machines,293,293,9
AZ-2014-1758207,211,19,3,Technology,Accessories,192,192,57
AZ-2014-176207,32,8,5,Office Supplies,Binders,24,24,40
AZ-2014-176207,115,14,5,Office Supplies,Storage,101,101,70
AZ-2014-1769606,28,1,1,Office Supplies,Art,27,27,1
AZ-2014-1769606,71,16,5,Office Supplies,Fasteners,55,55,80
AZ-2014-1785806,133,12,5,Office Supplies,Art,121,121,60
AZ-2014-1785806,1020,79,8,Office Supplies,Storage,941,941,632
AZ-2014-1790715,27,12,2,Office Supplies,Binders,15,15,24
AZ-2014-1790715,11,3,1,Office Supplies,Labels,8,8,3
AZ-2014-1790715,297,146,2,Technology,Copiers,151,151,292
AZ-2014-1803267,53,15,2,Office Supplies,Art,38,38,30
AZ-2014-1805424,22,7,3,Office Supplies,Binders,15,15,21
AZ-2014-1805424,34,6,3,Office Supplies,Labels,28,28,18
AZ-2014-1811710,51,14,6,Office Supplies,Binders,37,37,84
AZ-2014-181496,97,23,7,Office Supplies,Fasteners,74,74,161
AZ-2014-1826212,212,81,4,Furniture,Furnishings,131,131,324
AZ-2014-1832142,150,29,5,Office Supplies,Supplies,121,121,145
AZ-2014-1833043,117,57,7,Office Supplies,Fasteners,60,60,399
AZ-2014-183532,21,9,2,Office Supplies,Art,12,12,18
AZ-2014-183577,1054,337,2,Office Supplies,Appliances,717,717,674
AZ-2014-1846606,110,20,5,Office Supplies,Art,90,90,100
AZ-2014-1846606,156,62,6,Office Supplies,Envelopes,94,94,372
AZ-2014-1846606,529,137,3,Technology,Phones,392,392,411
AZ-2014-1861968,232,85,3,Office Supplies,Appliances,147,147,255
AZ-2014-1861968,174,-19,4,Office Supplies,Storage,193,193,-76
AZ-2014-186386,841,76,5,Technology,Phones,765,765,380
AZ-2014-186904,53,18,2,Office Supplies,Supplies,35,35,36
AZ-2014-1879822,77,30,7,Office Supplies,Fasteners,47,47,210
AZ-2014-1888707,198,24,8,Office Supplies,Supplies,174,174,192
AZ-2014-1891559,11,4,1,Office Supplies,Supplies,7,7,4
AZ-2014-1912622,88,19,3,Office Supplies,Binders,69,69,57
AZ-2014-1914770,92,42,2,Office Supplies,Art,50,50,84
AZ-2014-19192,33,2,2,Office Supplies,Storage,31,31,4
AZ-2014-1948946,97,31,3,Office Supplies,Supplies,66,66,93
AZ-2014-1954192,152,49,3,Office Supplies,Art,103,103,147
AZ-2014-1954192,51,16,7,Office Supplies,Binders,35,35,112
AZ-2014-1954439,131,41,3,Furniture,Furnishings,90,90,123
AZ-2014-1954439,72,-12,1,Technology,Machines,84,84,-12
AZ-2014-1957538,25,2,2,Office Supplies,Binders,23,23,4
AZ-2014-19623,63,14,7,Office Supplies,Binders,49,49,98
AZ-2014-1976505,557,260,3,Technology,Accessories,275,297,780
AZ-2014-1986339,205,70,4,Office Supplies,Storage,135,135,280
AZ-2014-1993253,285,14,2,Technology,Copiers,271,271,28
AZ-2014-2002086,38,9,2,Office Supplies,Art,29,29,18
AZ-2014-2013491,122,0,5,Office Supplies,Art,122,122,0
AZ-2014-2013491,40,-32,7,Office Supplies,Fasteners,72,72,-224
AZ-2014-2016291,637,113,5,Office Supplies,Storage,524,524,565
AZ-2014-2016291,67,19,1,Technology,Phones,48,48,19
AZ-2014-2017508,129,31,3,Office Supplies,Supplies,98,98,93
AZ-2014-2021789,107,9,2,Office Supplies,Art,98,98,18
AZ-2014-2032724,530,118,3,Furniture,Bookcases,412,412,354
AZ-2014-2032724,43,14,7,Office Supplies,Binders,17,29,98
AZ-2014-204778,59,8,2,Technology,Accessories,51,51,16
AZ-2014-2049231,237,79,4,Furniture,Chairs,158,158,316
AZ-2014-2049231,212,36,6,Office Supplies,Art,44,176,216
AZ-2014-2049231,40,16,3,Office Supplies,Binders,24,24,48
AZ-2014-2049231,928,260,3,Technology,Machines,668,668,780
AZ-2014-2049554,357,28,2,Office Supplies,Storage,329,329,56
AZ-2014-2056021,43,1,2,Office Supplies,Storage,42,42,2
AZ-2014-2071548,171,20,4,Office Supplies,Appliances,151,151,80
AZ-2014-2071548,9,0,2,Office Supplies,Binders,9,9,0
AZ-2014-2071548,51,22,4,Office Supplies,Labels,29,29,88
AZ-2014-2071548,574,144,3,Technology,Copiers,430,430,432
AZ-2014-2071548,1718,-134,3,Technology,Phones,1852,1852,-402
AZ-2014-2071834,1145,-687,6,Technology,Copiers,1832,1832,-4122
AZ-2014-2074276,35,4,3,Office Supplies,Labels,31,31,12
AZ-2014-2074276,249,64,2,Technology,Phones,185,185,128
AZ-2014-2076783,382,183,7,Office Supplies,Art,199,199,1281
AZ-2014-2076783,255,110,3,Technology,Accessories,145,145,330
AZ-2014-2088036,61,25,3,Office Supplies,Envelopes,36,36,75
AZ-2014-208875,876,420,7,Furniture,Bookcases,456,456,2940
AZ-2014-208875,19,6,1,Furniture,Furnishings,13,13,6
AZ-2014-208875,134,25,3,Office Supplies,Art,109,109,75
AZ-2014-208875,98,-3,3,Office Supplies,Storage,101,101,-9
AZ-2014-2103461,41,10,1,Furniture,Chairs,31,31,10
AZ-2014-2107464,78,5,7,Office Supplies,Labels,73,73,35
AZ-2014-2110602,159,73,3,Office Supplies,Binders,86,86,219
AZ-2014-2131403,87,24,7,Office Supplies,Art,63,63,168
AZ-2014-2131403,14,1,1,Office Supplies,Fasteners,13,13,1
AZ-2014-2131403,312,114,3,Technology,Machines,198,198,342
AZ-2014-2131616,8,2,1,Office Supplies,Labels,6,6,2
AZ-2014-2138061,222,44,2,Furniture,Furnishings,178,178,88
AZ-2014-2138061,94,27,2,Office Supplies,Supplies,67,67,54
AZ-2014-21710,66,27,5,Office Supplies,Labels,39,39,135
AZ-2014-2179018,214,53,2,Furniture,Furnishings,161,161,106
AZ-2014-2183629,103,50,2,Furniture,Furnishings,53,53,100
AZ-2014-2183629,174,50,5,Office Supplies,Supplies,24,124,250
AZ-2014-2188891,67,19,4,Office Supplies,Binders,48,48,76
AZ-2014-2194070,234,110,5,Office Supplies,Art,124,124,550
AZ-2014-2194070,672,87,4,Technology,Phones,585,585,348
AZ-2014-2194395,801,144,8,Technology,Accessories,657,657,1152
AZ-2014-2203949,33,-12,5,Office Supplies,Art,45,45,-60
AZ-2014-2203949,99,-82,4,Office Supplies,Binders,49,181,-328
AZ-2014-2203949,17,-11,2,Office Supplies,Paper,28,28,-22
AZ-2014-2210419,9,-3,3,Office Supplies,Binders,12,12,-9
AZ-2014-2210711,120,-89,2,Technology,Copiers,209,209,-178
AZ-2014-2215737,242,65,5,Office Supplies,Storage,177,177,325
AZ-2014-221897,50,24,3,Office Supplies,Fasteners,26,26,72
AZ-2014-2235626,84,28,3,Office Supplies,Binders,56,56,84
AZ-2014-2235626,954,219,3,Technology,Copiers,735,735,657
AZ-2014-2238445,19,4,1,Office Supplies,Art,15,15,4
AZ-2014-2238445,74,26,8,Office Supplies,Labels,48,48,208
AZ-2014-2258709,27,2,2,Office Supplies,Fasteners,25,25,4
AZ-2014-2264285,75,27,5,Office Supplies,Art,48,48,135
AZ-2014-2267437,368,4,3,Technology,Phones,364,364,12
AZ-2014-2277609,806,18,7,Office Supplies,Storage,788,788,126
AZ-2014-2277609,163,81,2,Technology,Accessories,82,82,162
AZ-2014-2277609,624,44,2,Technology,Machines,580,580,88
AZ-2014-2278287,3243,85,14,Furniture,Bookcases,381,3158,1190
AZ-2014-2278287,68,9,5,Office Supplies,Binders,59,59,45
AZ-2014-2278287,64,-7,3,Office Supplies,Storage,71,71,-21
AZ-2014-2278287,137,5,5,Office Supplies,Supplies,132,132,25
AZ-2014-2291964,38,7,6,Office Supplies,Binders,10,31,42
AZ-2014-2291964,39,17,3,Office Supplies,Fasteners,22,22,51
AZ-2014-2291964,322,-4,3,Office Supplies,Storage,326,326,-12
AZ-2014-2291964,150,3,1,Technology,Copiers,147,147,3
AZ-2014-2293716,973,161,6,Office Supplies,Storage,549,812,966
AZ-2014-2300523,59,5,2,Office Supplies,Paper,54,54,10
AZ-2014-2317283,1073,182,2,Office Supplies,Appliances,891,891,364
AZ-2014-2317283,146,-83,2,Technology,Machines,229,229,-166
AZ-2014-2323449,175,51,6,Office Supplies,Binders,124,124,306
AZ-2014-2335509,548,153,3,Furniture,Chairs,395,395,459
AZ-2014-2339680,977,271,3,Furniture,Bookcases,706,706,813
AZ-2014-2339680,122,61,3,Office Supplies,Envelopes,61,61,183
AZ-2014-2348970,26,9,2,Office Supplies,Labels,17,17,18
AZ-2014-2348996,37,4,4,Office Supplies,Fasteners,33,33,16
AZ-2014-2348996,220,49,5,Office Supplies,Storage,171,171,245
AZ-2014-2367501,177,11,8,Office Supplies,Supplies,166,166,88
AZ-2014-2406788,32,4,1,Furniture,Furnishings,28,28,4
AZ-2014-240841,298,86,2,Furniture,Chairs,212,212,172
AZ-2014-2413956,67,26,5,Office Supplies,Envelopes,41,41,130
AZ-2014-2414105,16,1,1,Office Supplies,Art,15,15,1
AZ-2014-241815,145,6,10,Office Supplies,Binders,139,139,60
AZ-2014-2419598,115,46,10,Office Supplies,Fasteners,69,69,460
AZ-2014-2419598,244,47,9,Office Supplies,Supplies,19,197,423
AZ-2014-2419598,287,46,4,Technology,Accessories,45,241,184
AZ-2014-2427220,144,30,2,Furniture,Chairs,114,114,60
AZ-2014-2432395,1060,360,4,Technology,Copiers,700,700,1440
AZ-2014-2432395,265,13,2,Technology,Phones,252,252,26
AZ-2014-2446526,55,13,1,Office Supplies,Storage,42,42,13
AZ-2014-2446526,181,8,4,Technology,Machines,173,173,32
AZ-2014-2452834,73,0,6,Office Supplies,Art,73,73,0
AZ-2014-2478728,77,27,3,Office Supplies,Art,50,50,81
AZ-2014-2478728,59,7,4,Office Supplies,Binders,23,52,28
AZ-2014-2483272,44,14,6,Office Supplies,Binders,30,30,84
AZ-2014-2483272,25,12,2,Office Supplies,Envelopes,13,13,24
AZ-2014-2483272,192,90,6,Technology,Accessories,102,102,540
AZ-2014-2490387,37,7,3,Office Supplies,Fasteners,30,30,21
AZ-2014-2492440,39,3,3,Office Supplies,Binders,36,36,9
AZ-2014-2500745,193,33,5,Technology,Accessories,160,160,165
AZ-2014-2500745,336,44,2,Technology,Phones,292,292,88
AZ-2014-2510582,892,159,7,Office Supplies,Storage,733,733,1113
AZ-2014-2533893,154,3,4,Office Supplies,Appliances,151,151,12
AZ-2014-2539403,194,74,4,Office Supplies,Paper,120,120,296
AZ-2014-2539403,381,80,5,Technology,Phones,301,301,400
AZ-2014-2576958,844,8,6,Office Supplies,Storage,836,836,48
AZ-2014-2583309,54,1,2,Office Supplies,Storage,53,53,2
AZ-2014-2584189,21,7,2,Office Supplies,Binders,14,14,14
AZ-2014-2584189,28,9,3,Office Supplies,Labels,19,19,27
AZ-2014-2584189,286,11,4,Technology,Accessories,275,275,44
AZ-2014-2584189,1864,708,6,Technology,Machines,1156,1156,4248
AZ-2014-2593220,27,5,2,Office Supplies,Labels,22,22,10
AZ-2014-2602647,44,11,1,Office Supplies,Storage,33,33,11
AZ-2014-2604590,109,29,1,Technology,Machines,80,80,29
AZ-2014-2638814,57,12,4,Office Supplies,Binders,45,45,48
AZ-2014-2640603,737,0,5,Technology,Copiers,737,737,0
AZ-2014-2658996,140,46,5,Office Supplies,Binders,94,94,230
AZ-2014-2661434,70,-42,4,Furniture,Furnishings,112,112,-168
AZ-2014-2661434,17,-3,2,Office Supplies,Fasteners,20,20,-6
AZ-2014-2672334,5,1,1,Office Supplies,Labels,4,4,1
AZ-2014-2681934,1705,409,3,Office Supplies,Appliances,1296,1296,1227
AZ-2014-2684654,93,45,5,Office Supplies,Fasteners,48,48,225
AZ-2014-2687996,190,36,7,Furniture,Furnishings,154,154,252
AZ-2014-2694550,347,16,5,Technology,Phones,331,331,80
AZ-2014-2699091,227,34,4,Office Supplies,Art,193,193,136
AZ-2014-270140,68,7,2,Office Supplies,Paper,61,61,14
AZ-2014-2718227,193,96,6,Office Supplies,Art,97,97,576
AZ-2014-2733980,78,3,6,Office Supplies,Fasteners,75,75,18
AZ-2014-2733980,47,21,2,Office Supplies,Paper,26,26,42
AZ-2014-2733980,473,194,4,Technology,Copiers,279,279,776
AZ-2014-2748286,116,20,3,Technology,Accessories,96,96,60
AZ-2014-2748286,846,228,6,Technology,Copiers,618,618,1368
AZ-2014-2748286,159,-11,2,Technology,Phones,170,170,-22
AZ-2014-2748626,38,3,2,Office Supplies,Fasteners,35,35,6
AZ-2014-2750080,140,45,4,Office Supplies,Supplies,95,95,180
AZ-2014-2750080,296,-158,4,Technology,Phones,454,454,-632
AZ-2014-275213,2050,68,5,Furniture,Chairs,1982,1982,340
AZ-2014-2752390,30,9,3,Office Supplies,Supplies,21,21,27
AZ-2014-2763663,220,18,2,Furniture,Furnishings,202,202,36
AZ-2014-2763663,81,10,2,Technology,Accessories,71,71,20
AZ-2014-2763663,479,239,4,Technology,Copiers,240,240,956
AZ-2014-2767190,605,218,2,Office Supplies,Appliances,387,387,436
AZ-2014-2767190,66,13,6,Office Supplies,Fasteners,53,53,78
AZ-2014-2767190,68,27,4,Office Supplies,Storage,41,41,108
AZ-2014-279343,110,31,4,Office Supplies,Binders,79,79,124
AZ-2014-2800894,279,129,8,Office Supplies,Binders,143,150,1032
AZ-2014-2800894,207,35,1,Office Supplies,Storage,172,172,35
AZ-2014-2804403,197,20,4,Office Supplies,Envelopes,177,177,80
AZ-2014-2804403,74,23,8,Office Supplies,Labels,51,51,184
AZ-2014-2804403,105,40,2,Office Supplies,Storage,65,65,80
AZ-2014-2805092,1683,-56,4,Furniture,Chairs,1739,1739,-224
AZ-2014-2805092,557,217,3,Office Supplies,Storage,340,340,651
AZ-2014-2805502,135,28,3,Furniture,Furnishings,107,107,84
AZ-2014-2816978,30,-1,3,Office Supplies,Labels,31,31,-3
AZ-2014-2827922,134,56,5,Office Supplies,Supplies,78,78,280
AZ-2014-2835554,714,309,4,Office Supplies,Storage,405,405,1236
AZ-2014-2846196,105,24,4,Office Supplies,Binders,73,81,96
AZ-2014-2846196,59,4,6,Office Supplies,Labels,30,55,24
AZ-2014-2846196,1244,-14,7,Office Supplies,Storage,1258,1258,-98
AZ-2014-2853843,194,84,4,Office Supplies,Art,110,110,336
AZ-2014-285574,94,16,5,Office Supplies,Envelopes,78,78,80
AZ-2014-2857176,250,100,3,Office Supplies,Appliances,150,150,300
AZ-2014-2857176,57,5,3,Office Supplies,Supplies,52,52,15
AZ-2014-2860692,1235,469,3,Furniture,Bookcases,766,766,1407
AZ-2014-2860692,56,27,2,Office Supplies,Paper,29,29,54
AZ-2014-2860692,29,3,1,Office Supplies,Storage,26,26,3
AZ-2014-2860692,102,-67,2,Technology,Machines,169,169,-134
AZ-2014-2874251,29,2,3,Office Supplies,Envelopes,27,27,6
AZ-2014-2884391,25,3,2,Office Supplies,Binders,22,22,6
AZ-2014-2885324,79,40,3,Office Supplies,Storage,39,39,120
AZ-2014-2886352,261,10,1,Technology,Machines,251,251,10
AZ-2014-2889820,689,7,13,Furniture,Furnishings,682,682,91
AZ-2014-2889820,2478,1041,5,Office Supplies,Appliances,1437,1437,5205
AZ-2014-2897959,170,51,2,Office Supplies,Appliances,119,119,102
AZ-2014-2899056,957,202,8,Furniture,Chairs,755,755,1616
AZ-2014-2916681,372,33,1,Furniture,Bookcases,339,339,33
AZ-2014-2916681,364,-20,3,Furniture,Chairs,384,384,-60
AZ-2014-2920974,667,133,6,Furniture,Furnishings,534,534,798
AZ-2014-2920974,41,18,4,Office Supplies,Art,23,23,72
AZ-2014-2920974,309,77,6,Office Supplies,Binders,232,232,462
AZ-2014-2920974,49,6,1,Office Supplies,Storage,43,43,6
AZ-2014-2926551,25,11,3,Office Supplies,Fasteners,14,14,33
AZ-2014-2938104,1314,378,4,Furniture,Bookcases,936,936,1512
AZ-2014-2938104,34,13,2,Furniture,Furnishings,21,21,26
AZ-2014-2938104,461,-26,7,Technology,Phones,487,487,-182
AZ-2014-2942129,221,75,4,Furniture,Furnishings,146,146,300
AZ-2014-2942129,370,170,7,Office Supplies,Binders,200,200,1190
AZ-2014-2942129,368,74,2,Office Supplies,Storage,294,294,148
AZ-2014-2950767,28,1,1,Office Supplies,Art,27,27,1
AZ-2014-2961810,104,19,2,Office Supplies,Binders,85,85,38
AZ-2014-2981657,1032,124,8,Furniture,Chairs,908,908,992
AZ-2014-2981657,1601,16,6,Technology,Machines,1585,1585,96
AZ-2014-2987514,71,19,3,Office Supplies,Paper,52,52,57
AZ-2014-2987514,156,-2,6,Office Supplies,Storage,38,158,-12
AZ-2014-2987514,328,35,2,Technology,Copiers,293,293,70
AZ-2014-2995713,64,32,2,Office Supplies,Art,32,32,64
AZ-2014-2995713,227,68,8,Office Supplies,Binders,159,159,544
AZ-2014-2995713,59,30,3,Office Supplies,Fasteners,29,29,90
AZ-2014-2995713,415,8,7,Technology,Accessories,407,407,56
AZ-2014-3004222,35,16,3,Office Supplies,Labels,19,19,48
AZ-2014-3004222,252,91,7,Office Supplies,Storage,39,161,637
AZ-2014-3004222,696,74,10,Technology,Accessories,233,622,740
AZ-2014-3004222,414,21,3,Technology,Phones,393,393,63
AZ-2014-3013226,194,58,4,Office Supplies,Binders,136,136,232
AZ-2014-3013226,148,-40,5,Office Supplies,Storage,188,188,-200
AZ-2014-3020492,996,120,5,Furniture,Bookcases,876,876,600
AZ-2014-3020492,777,171,4,Technology,Copiers,606,606,684
AZ-2014-3025995,138,58,7,Office Supplies,Art,80,80,406
AZ-2014-302639,728,44,5,Technology,Copiers,684,684,220
AZ-2014-3031109,37,14,3,Office Supplies,Labels,23,23,42
AZ-2014-3032977,96,35,3,Office Supplies,Binders,61,61,105
AZ-2014-3039763,187,7,7,Office Supplies,Art,180,180,49
AZ-2014-3040435,131,52,11,Office Supplies,Binders,51,79,572
AZ-2014-3040435,188,41,4,Office Supplies,Envelopes,147,147,164
AZ-2014-3040435,633,83,6,Office Supplies,Storage,506,550,498
AZ-2014-3079618,9,4,1,Office Supplies,Labels,5,5,4
AZ-2014-3085077,362,36,3,Office Supplies,Storage,326,326,108
AZ-2014-3085077,191,8,7,Office Supplies,Supplies,183,183,56
AZ-2014-3101518,277,26,5,Technology,Phones,251,251,130
AZ-2014-3107566,70,13,3,Office Supplies,Art,57,57,39
AZ-2014-3107566,294,88,6,Office Supplies,Storage,206,206,528
AZ-2014-313741,449,135,3,Furniture,Bookcases,314,314,405
AZ-2014-313741,103,26,2,Office Supplies,Binders,77,77,52
AZ-2014-3145112,47,8,1,Furniture,Chairs,39,39,8
AZ-2014-3145112,201,74,3,Office Supplies,Appliances,127,127,222
AZ-2014-3145770,112,-1,5,Office Supplies,Art,77,113,-5
AZ-2014-3145770,110,24,8,Office Supplies,Envelopes,86,86,192
AZ-2014-3145770,34,5,3,Office Supplies,Labels,29,29,15
AZ-2014-3146183,53,9,1,Office Supplies,Paper,44,44,9
AZ-2014-3146183,257,110,2,Office Supplies,Storage,147,147,220
AZ-2014-3152192,218,77,2,Furniture,Bookcases,141,141,154
AZ-2014-3152192,263,51,5,Office Supplies,Art,129,212,255
AZ-2014-3152192,44,14,3,Office Supplies,Binders,30,30,42
AZ-2014-3152192,158,32,5,Office Supplies,Supplies,126,126,160
AZ-2014-3154737,349,108,8,Office Supplies,Paper,241,241,864
AZ-2014-3159501,94,34,2,Furniture,Furnishings,60,60,68
AZ-2014-3163636,291,17,5,Furniture,Furnishings,274,274,85
AZ-2014-3163636,603,0,2,Technology,Copiers,603,603,0
AZ-2014-3178451,37,0,3,Office Supplies,Art,37,37,0
AZ-2014-3178451,292,114,7,Technology,Accessories,178,178,798
AZ-2014-3184977,59,12,2,Office Supplies,Binders,47,47,24
AZ-2014-3184977,41,1,2,Office Supplies,Storage,40,40,2
AZ-2014-3184977,371,74,3,Technology,Copiers,297,297,222
AZ-2014-3185599,145,59,5,Office Supplies,Art,86,86,295
AZ-2014-3200941,814,217,6,Furniture,Bookcases,597,597,1302
AZ-2014-3200941,27,3,7,Office Supplies,Binders,24,24,21
AZ-2014-3200941,513,-91,2,Technology,Machines,604,604,-182
AZ-2014-3203712,126,18,5,Furniture,Furnishings,108,108,90
AZ-2014-3203712,75,24,6,Office Supplies,Labels,23,51,144
AZ-2014-3203712,107,45,4,Office Supplies,Supplies,62,62,180
AZ-2014-320668,676,195,5,Furniture,Bookcases,481,481,975
AZ-2014-320668,138,11,5,Office Supplies,Art,127,127,55
AZ-2014-320668,248,72,16,Office Supplies,Binders,129,176,1152
AZ-2014-320668,776,140,3,Technology,Accessories,636,636,420
AZ-2014-3247933,101,32,2,Office Supplies,Art,69,69,64
AZ-2014-3255631,297,39,4,Furniture,Chairs,258,258,156
AZ-2014-3255631,42,3,3,Office Supplies,Fasteners,39,39,9
AZ-2014-325624,184,59,3,Furniture,Chairs,125,125,177
AZ-2014-325624,91,20,4,Office Supplies,Art,23,71,80
AZ-2014-325624,38,18,2,Office Supplies,Envelopes,20,20,36
AZ-2014-325624,43,18,3,Office Supplies,Fasteners,25,25,54
AZ-2014-325624,764,84,4,Technology,Copiers,680,680,336
AZ-2014-3264915,276,135,7,Office Supplies,Supplies,141,141,945
AZ-2014-327161,346,55,7,Office Supplies,Art,291,291,385
AZ-2014-3279788,138,23,4,Office Supplies,Storage,115,115,92
AZ-2014-3279788,43,20,1,Office Supplies,Supplies,23,23,20
AZ-2014-3281125,114,1,2,Office Supplies,Art,113,113,2
AZ-2014-3281125,409,118,8,Office Supplies,Binders,291,291,944
AZ-2014-3281125,109,52,8,Office Supplies,Fasteners,57,57,416
AZ-2014-3302938,78,-50,3,Office Supplies,Binders,128,128,-150
AZ-2014-3302938,29,-6,3,Office Supplies,Fasteners,35,35,-18
AZ-2014-3303023,103,39,6,Office Supplies,Fasteners,64,64,234
AZ-2014-3303023,1953,332,9,Technology,Accessories,1484,1621,2988
AZ-2014-3332040,3221,1127,7,Furniture,Chairs,2094,2094,7889
AZ-2014-3332040,228,36,5,Office Supplies,Art,192,192,180
AZ-2014-3332040,298,40,10,Office Supplies,Envelopes,153,258,400
AZ-2014-3332040,79,39,4,Office Supplies,Fasteners,40,40,156
AZ-2014-3332040,36,7,2,Office Supplies,Paper,29,29,14
AZ-2014-3332040,1655,197,9,Office Supplies,Storage,1181,1458,1773
AZ-2014-3332040,19,1,1,Office Supplies,Supplies,18,18,1
AZ-2014-3332040,1846,794,7,Technology,Copiers,1052,1052,5558
AZ-2014-3348489,32,2,2,Office Supplies,Envelopes,30,30,4
AZ-2014-3348489,34,10,2,Office Supplies,Paper,24,24,20
AZ-2014-3348489,536,133,11,Office Supplies,Storage,62,403,1463
AZ-2014-3348489,57,5,3,Office Supplies,Supplies,52,52,15
AZ-2014-3360679,20,9,2,Office Supplies,Binders,11,11,18
AZ-2014-3360679,68,29,2,Office Supplies,Paper,39,39,58
AZ-2014-3360679,75,-44,2,Office Supplies,Storage,119,119,-88
AZ-2014-3367172,80,37,6,Office Supplies,Binders,43,43,222
AZ-2014-3367172,1600,720,5,Technology,Copiers,880,880,3600
AZ-2014-3370172,51,23,2,Furniture,Furnishings,28,28,46
AZ-2014-3374412,26,7,3,Office Supplies,Envelopes,19,19,21
AZ-2014-3387010,125,15,3,Office Supplies,Supplies,110,110,45
AZ-2014-338779,973,205,2,Office Supplies,Appliances,768,768,410
AZ-2014-338779,505,125,12,Office Supplies,Art,113,380,1500
AZ-2014-338779,163,12,8,Office Supplies,Binders,83,151,96
AZ-2014-338779,247,82,2,Office Supplies,Storage,165,165,164
AZ-2014-3393517,197,57,3,Furniture,Chairs,140,140,171
AZ-2014-3436015,410,135,1,Furniture,Bookcases,275,275,135
AZ-2014-3436015,329,23,16,Office Supplies,Art,138,306,368
AZ-2014-3436015,363,76,5,Technology,Accessories,287,287,380
AZ-2014-3437856,79,7,3,Office Supplies,Art,72,72,21
AZ-2014-3445834,440,154,8,Office Supplies,Art,286,286,1232
AZ-2014-3445834,54,5,2,Office Supplies,Envelopes,49,49,10
AZ-2014-3489537,136,57,4,Office Supplies,Paper,79,79,228
AZ-2014-3489537,553,110,3,Office Supplies,Storage,443,443,330
AZ-2014-3494429,566,272,4,Furniture,Bookcases,294,294,1088
AZ-2014-3494429,115,5,2,Office Supplies,Appliances,110,110,10
AZ-2014-3494429,339,95,11,Office Supplies,Binders,244,244,1045
AZ-2014-3494429,77,14,3,Office Supplies,Envelopes,33,63,42
AZ-2014-3494429,25,5,2,Office Supplies,Fasteners,20,20,10
AZ-2014-3494429,498,80,4,Technology,Copiers,418,418,320
AZ-2014-3494429,755,201,6,Technology,Phones,554,554,1206
AZ-2014-3500808,218,105,4,Office Supplies,Art,113,113,420
AZ-2014-3500808,14,4,2,Office Supplies,Binders,10,10,8
AZ-2014-3500808,33,7,3,Office Supplies,Fasteners,26,26,21
AZ-2014-3500808,8,2,2,Office Supplies,Labels,6,6,4
AZ-2014-3500808,260,78,5,Office Supplies,Storage,182,182,390
AZ-2014-3500808,347,135,2,Technology,Phones,212,212,270
AZ-2014-3504387,401,27,3,Furniture,Bookcases,374,374,81
AZ-2014-3504387,106,49,8,Office Supplies,Binders,57,57,392
AZ-2014-3504387,271,127,14,Office Supplies,Fasteners,144,144,1778
AZ-2014-3540181,71,23,3,Furniture,Furnishings,48,48,69
AZ-2014-3540181,16,2,4,Office Supplies,Binders,14,14,8
AZ-2014-356444,23,6,2,Office Supplies,Binders,17,17,12
AZ-2014-356444,9,4,1,Office Supplies,Labels,5,5,4
AZ-2014-3599759,240,22,5,Office Supplies,Supplies,218,218,110
AZ-2014-3603253,47,16,2,Office Supplies,Art,31,31,32
AZ-2014-3603664,23,2,6,Office Supplies,Binders,21,21,12
AZ-2014-36141,1177,405,3,Furniture,Bookcases,772,772,1215
AZ-2014-36141,21,5,3,Office Supplies,Labels,16,16,15
AZ-2014-3621683,872,253,7,Furniture,Bookcases,619,619,1771
AZ-2014-3621683,42,8,3,Office Supplies,Fasteners,34,34,24
AZ-2014-3625320,8,3,1,Office Supplies,Binders,5,5,3
AZ-2014-3625320,65,11,4,Office Supplies,Fasteners,54,54,44
AZ-2014-3625438,95,38,5,Office Supplies,Art,57,57,190
AZ-2014-3628552,180,-135,8,Furniture,Chairs,315,315,-1080
AZ-2014-3628552,311,102,7,Office Supplies,Art,209,209,714
AZ-2014-3635641,417,-78,3,Furniture,Chairs,495,495,-234
AZ-2014-3635641,8,3,1,Office Supplies,Binders,5,5,3
AZ-2014-3635641,105,40,2,Office Supplies,Storage,65,65,80
AZ-2014-3636472,108,43,4,Office Supplies,Envelopes,65,65,172
AZ-2014-3636472,67,13,4,Office Supplies,Paper,54,54,52
AZ-2014-3636472,103,-3,2,Office Supplies,Storage,106,106,-6
AZ-2014-3637939,189,60,4,Office Supplies,Art,57,129,240
AZ-2014-3637939,53,6,2,Office Supplies,Binders,47,47,12
AZ-2014-3637939,414,6,6,Office Supplies,Storage,197,408,36
AZ-2014-3638648,83,11,10,Office Supplies,Labels,72,72,110
AZ-2014-3658958,95,18,2,Office Supplies,Art,77,77,36
AZ-2014-3666609,164,57,2,Office Supplies,Appliances,107,107,114
AZ-2014-3666609,38,17,5,Office Supplies,Binders,21,21,85
AZ-2014-3673606,253,13,3,Furniture,Chairs,240,240,39
AZ-2014-3673606,1133,294,8,Office Supplies,Storage,839,839,2352
AZ-2014-3685250,169,32,7,Office Supplies,Art,137,137,224
AZ-2014-3685250,32,3,2,Office Supplies,Binders,29,29,6
AZ-2014-3685250,119,47,3,Technology,Accessories,72,72,141
AZ-2014-3694312,36,7,3,Office Supplies,Fasteners,29,29,21
AZ-2014-369464,3768,1629,13,Furniture,Bookcases,1478,2139,21177
AZ-2014-369464,766,139,17,Office Supplies,Art,44,627,2363
AZ-2014-369464,325,32,7,Office Supplies,Envelopes,293,293,224
AZ-2014-3706282,123,8,9,Office Supplies,Binders,22,115,72
AZ-2014-371022,106,34,2,Technology,Accessories,72,72,68
AZ-2014-3740104,28,10,2,Office Supplies,Binders,18,18,20
AZ-2014-3745040,70,32,6,Office Supplies,Labels,38,38,192
AZ-2014-3745040,599,0,2,Technology,Copiers,599,599,0
AZ-2014-3762374,30,3,2,Office Supplies,Binders,27,27,6
AZ-2014-3762374,1023,123,8,Office Supplies,Storage,900,900,984
AZ-2014-3762374,108,6,5,Office Supplies,Supplies,102,102,30
AZ-2014-3767753,52,18,2,Office Supplies,Art,34,34,36
AZ-2014-3770776,136,48,1,Furniture,Chairs,88,88,48
AZ-2014-3770776,76,11,5,Office Supplies,Binders,65,65,55
AZ-2014-3772714,193,15,7,Office Supplies,Art,118,178,105
AZ-2014-3772714,24,8,2,Office Supplies,Binders,16,16,16
AZ-2014-3772714,59,18,6,Office Supplies,Fasteners,41,41,108
AZ-2014-3772714,13,2,2,Office Supplies,Labels,11,11,4
AZ-2014-3772714,27,8,1,Office Supplies,Paper,19,19,8
AZ-2014-3772714,202,83,2,Technology,Accessories,119,119,166
AZ-2014-3774339,324,36,3,Furniture,Furnishings,288,288,108
AZ-2014-3774339,58,14,5,Office Supplies,Binders,44,44,70
AZ-2014-3774339,22,0,1,Office Supplies,Storage,22,22,0
AZ-2014-3774339,95,47,2,Office Supplies,Supplies,48,48,94
AZ-2014-3774339,495,-35,7,Technology,Machines,530,530,-245
AZ-2014-378120,34,1,2,Office Supplies,Binders,33,33,2
AZ-2014-378120,207,56,5,Office Supplies,Supplies,151,151,280
AZ-2014-3798193,33,9,5,Office Supplies,Binders,24,24,45
AZ-2014-3802828,307,67,12,Office Supplies,Art,173,240,804
AZ-2014-3802828,260,47,1,Technology,Copiers,213,213,47
AZ-2014-3810373,840,143,5,Technology,Phones,697,697,715
AZ-2014-3811134,23,5,2,Office Supplies,Art,18,18,10
AZ-2014-3811134,112,27,9,Office Supplies,Labels,85,85,243
AZ-2014-3811134,291,93,7,Technology,Accessories,198,198,651
AZ-2014-3811327,50,-49,1,Furniture,Bookcases,99,99,-49
AZ-2014-3811327,10,-8,2,Office Supplies,Labels,18,18,-16
AZ-2014-3811327,108,-13,3,Technology,Phones,121,121,-39
AZ-2014-381698,717,16,4,Furniture,Bookcases,701,701,64
AZ-2014-3822265,30,3,2,Office Supplies,Binders,27,27,6
AZ-2014-3822265,496,17,4,Office Supplies,Storage,479,479,68
AZ-2014-383147,118,41,4,Office Supplies,Art,77,77,164
AZ-2014-383147,18,7,2,Office Supplies,Fasteners,11,11,14
AZ-2014-3840915,134,37,5,Office Supplies,Art,97,97,185
AZ-2014-3840915,1733,208,7,Technology,Accessories,1525,1525,1456
AZ-2014-3848321,170,73,2,Technology,Accessories,97,97,146
AZ-2014-3851368,323,118,9,Office Supplies,Art,36,205,1062
AZ-2014-3851368,38,13,3,Office Supplies,Labels,25,25,39
AZ-2014-3851368,413,186,2,Office Supplies,Storage,227,227,372
AZ-2014-3851368,338,118,4,Technology,Machines,220,220,472
AZ-2014-3853517,249,17,5,Office Supplies,Paper,232,232,85
AZ-2014-3855882,40,17,5,Office Supplies,Binders,23,23,85
AZ-2014-3870231,152,44,3,Office Supplies,Art,108,108,132
AZ-2014-3870231,30,1,2,Office Supplies,Supplies,29,29,2
AZ-2014-3870231,1913,899,10,Technology,Copiers,1014,1014,8990
AZ-2014-3870231,292,35,4,Technology,Phones,257,257,140
AZ-2014-3872710,28,3,2,Office Supplies,Fasteners,25,25,6
AZ-2014-3885179,254,81,5,Office Supplies,Art,173,173,405
AZ-2014-3885179,94,21,2,Office Supplies,Envelopes,73,73,42
AZ-2014-3885179,167,5,1,Technology,Phones,162,162,5
AZ-2014-3888440,86,19,2,Office Supplies,Supplies,67,67,38
AZ-2014-3892421,27,5,2,Office Supplies,Paper,22,22,10
AZ-2014-3909532,36,16,5,Office Supplies,Envelopes,20,20,80
AZ-2014-3909532,68,28,2,Office Supplies,Paper,40,40,56
AZ-2014-3909532,458,110,17,Office Supplies,Storage,151,348,1870
AZ-2014-3909532,129,46,3,Technology,Accessories,83,83,138
AZ-2014-3937200,103,30,2,Furniture,Furnishings,73,73,60
AZ-2014-3937200,85,0,3,Office Supplies,Binders,85,85,0
AZ-2014-3937200,100,25,9,Office Supplies,Labels,75,75,225
AZ-2014-3937200,162,78,7,Office Supplies,Supplies,84,84,546
AZ-2014-3937200,2057,432,7,Technology,Copiers,1625,1625,3024
AZ-2014-3937200,292,13,4,Technology,Machines,279,279,52
AZ-2014-3938164,46,9,3,Furniture,Furnishings,37,37,27
AZ-2014-3954912,329,95,7,Office Supplies,Supplies,234,234,665
AZ-2014-3958582,1015,272,4,Technology,Accessories,307,743,1088
AZ-2014-3958582,211,-123,2,Technology,Machines,334,334,-246
AZ-2014-3967797,42,8,3,Office Supplies,Fasteners,34,34,24
AZ-2014-3967797,110,-12,5,Office Supplies,Storage,122,122,-60
AZ-2014-3967797,332,113,7,Technology,Machines,219,219,791
AZ-2014-3980434,242,14,5,Furniture,Furnishings,228,228,70
AZ-2014-3981915,15,7,2,Office Supplies,Binders,8,8,14
AZ-2014-3981915,174,72,4,Office Supplies,Storage,102,102,288
AZ-2014-3985814,1072,311,4,Technology,Machines,761,761,1244
AZ-2014-399532,88,40,2,Furniture,Furnishings,48,48,80
AZ-2014-399532,18,2,3,Office Supplies,Binders,16,16,6
AZ-2014-399532,465,140,4,Technology,Accessories,325,325,560
AZ-2014-3997418,54,15,4,Office Supplies,Supplies,39,39,60
AZ-2014-4000369,89,8,4,Office Supplies,Art,81,81,32
AZ-2014-4000369,1016,-24,5,Technology,Copiers,1040,1040,-120
AZ-2014-4004441,33,9,2,Office Supplies,Binders,24,24,18
AZ-2014-4010374,29,0,2,Office Supplies,Storage,29,29,0
AZ-2014-4010374,882,185,3,Technology,Copiers,697,697,555
AZ-2014-4010374,2088,84,8,Technology,Machines,2004,2004,672
AZ-2014-4015519,157,59,3,Office Supplies,Appliances,98,98,177
AZ-2014-4015519,529,6,5,Technology,Copiers,523,523,30
AZ-2014-4015519,429,10,4,Technology,Phones,419,419,40
AZ-2014-4019056,11,1,1,Office Supplies,Storage,10,10,1
AZ-2014-4019056,351,84,3,Technology,Machines,267,267,252
AZ-2014-4019056,279,114,2,Technology,Phones,165,165,228
AZ-2014-4031340,103,44,4,Office Supplies,Envelopes,59,59,176
AZ-2014-4039650,1860,18,7,Technology,Machines,1842,1842,126
AZ-2014-4042743,87,9,7,Office Supplies,Binders,78,78,63
AZ-2014-4042743,226,61,6,Office Supplies,Envelopes,165,165,366
AZ-2014-4045031,936,66,3,Technology,Machines,870,870,198
AZ-2014-4059237,77,18,4,Office Supplies,Art,59,59,72
AZ-2014-4059237,40,10,2,Office Supplies,Envelopes,30,30,20
AZ-2014-4059237,578,212,5,Office Supplies,Storage,366,366,1060
AZ-2014-4093639,62,27,6,Office Supplies,Art,35,35,162
AZ-2014-4093639,104,25,9,Office Supplies,Binders,79,79,225
AZ-2014-4112590,37,14,3,Office Supplies,Envelopes,23,23,42
AZ-2014-4112918,1955,608,4,Office Supplies,Appliances,1347,1347,2432
AZ-2014-4112918,157,59,3,Office Supplies,Storage,98,98,177
AZ-2014-4112918,22,1,1,Office Supplies,Supplies,21,21,1
AZ-2014-4112918,116,35,1,Technology,Accessories,81,81,35
AZ-2014-4112918,829,146,7,Technology,Phones,683,683,1022
AZ-2014-4114625,53,26,3,Furniture,Furnishings,27,27,78
AZ-2014-4135544,147,21,2,Technology,Phones,126,126,42
AZ-2014-4151029,90,36,3,Office Supplies,Binders,54,54,108
AZ-2014-4151029,229,37,2,Technology,Accessories,192,192,74
AZ-2014-4158813,332,111,9,Office Supplies,Art,12,221,999
AZ-2014-4158813,95,14,14,Office Supplies,Labels,81,81,196
AZ-2014-4160520,101,23,2,Furniture,Chairs,78,78,46
AZ-2014-4182023,169,-3,6,Office Supplies,Storage,172,172,-18
AZ-2014-4182023,159,21,2,Technology,Accessories,138,138,42
AZ-2014-4182023,1209,242,5,Technology,Copiers,967,967,1210
AZ-2014-4188403,596,91,4,Technology,Machines,505,505,364
AZ-2014-4217323,557,217,3,Office Supplies,Storage,340,340,651
AZ-2014-4220771,1399,109,3,Furniture,Tables,1290,1290,327
AZ-2014-4226060,430,95,3,Furniture,Bookcases,335,335,285
AZ-2014-4226060,82,23,3,Office Supplies,Binders,59,59,69
AZ-2014-4236300,326,153,4,Furniture,Chairs,173,173,612
AZ-2014-4236300,82,33,4,Office Supplies,Envelopes,49,49,132
AZ-2014-4236300,427,132,3,Technology,Copiers,295,295,396
AZ-2014-4237223,124,28,6,Office Supplies,Binders,36,96,168
AZ-2014-423825,54,4,3,Office Supplies,Art,50,50,12
AZ-2014-4241465,311,43,13,Office Supplies,Binders,262,268,559
AZ-2014-4241465,136,56,4,Office Supplies,Paper,80,80,224
AZ-2014-4241465,50,20,3,Office Supplies,Supplies,30,30,60
AZ-2014-4255691,333,74,6,Office Supplies,Storage,259,259,444
AZ-2014-4255691,238,117,5,Office Supplies,Supplies,121,121,585
AZ-2014-4257204,158,65,5,Office Supplies,Binders,93,93,325
AZ-2014-4257204,116,52,7,Office Supplies,Storage,64,64,364
AZ-2014-4258600,44,10,3,Office Supplies,Art,34,34,30
AZ-2014-4258600,59,5,2,Office Supplies,Paper,54,54,10
AZ-2014-4277891,143,41,1,Furniture,Bookcases,102,102,41
AZ-2014-4277891,141,3,6,Office Supplies,Art,138,138,18
AZ-2014-4277891,80,37,6,Office Supplies,Binders,43,43,222
AZ-2014-4277891,83,3,2,Office Supplies,Envelopes,80,80,6
AZ-2014-4277955,168,55,9,Office Supplies,Art,18,113,495
AZ-2014-4277955,95,43,4,Office Supplies,Paper,52,52,172
AZ-2014-4279735,2077,395,4,Office Supplies,Appliances,1682,1682,1580
AZ-2014-4279735,603,205,5,Technology,Machines,398,398,1025
AZ-2014-4281843,19,-13,2,Office Supplies,Fasteners,32,32,-26
AZ-2014-4284397,24,6,1,Office Supplies,Paper,18,18,6
AZ-2014-4295030,193,73,6,Office Supplies,Art,120,120,438
AZ-2014-4295830,374,42,3,Furniture,Chairs,332,332,126
AZ-2014-4303771,591,118,3,Office Supplies,Storage,473,473,354
AZ-2014-4303771,521,10,7,Technology,Phones,511,511,70
AZ-2014-4315429,732,220,3,Technology,Accessories,512,512,660
AZ-2014-4317243,977,271,3,Furniture,Bookcases,706,706,813
AZ-2014-4321659,59,21,2,Office Supplies,Art,38,38,42
AZ-2014-4321659,163,13,2,Technology,Accessories,150,150,26
AZ-2014-4329133,55,-17,2,Office Supplies,Art,72,72,-34
AZ-2014-4329133,12,-2,3,Office Supplies,Fasteners,14,14,-6
AZ-2014-4339601,157,24,3,Furniture,Chairs,133,133,72
AZ-2014-4339601,41,6,3,Office Supplies,Binders,35,35,18
AZ-2014-4346443,108,25,2,Office Supplies,Art,83,83,50
AZ-2014-4346443,218,31,9,Office Supplies,Storage,187,187,279
AZ-2014-4360441,53,24,6,Office Supplies,Binders,29,29,144
AZ-2014-4362946,89,15,3,Office Supplies,Binders,74,74,45
AZ-2014-4362946,237,-119,2,Office Supplies,Storage,356,356,-238
AZ-2014-436448,45,6,3,Office Supplies,Binders,39,39,18
AZ-2014-4403540,18,3,2,Office Supplies,Binders,15,15,6
AZ-2014-4414949,21,5,2,Office Supplies,Binders,16,16,10
AZ-2014-4414949,93,44,4,Office Supplies,Supplies,49,49,176
AZ-2014-4467303,39,12,3,Office Supplies,Binders,27,27,36
AZ-2014-4467303,60,25,3,Office Supplies,Storage,35,35,75
AZ-2014-4467303,789,-84,6,Technology,Phones,873,873,-504
AZ-2014-4484783,1335,374,8,Technology,Phones,961,961,2992
AZ-2014-449112,26,10,2,Office Supplies,Binders,16,16,20
AZ-2014-4502269,90,8,8,Office Supplies,Art,82,82,64
AZ-2014-4524252,987,89,5,Office Supplies,Storage,898,898,445
AZ-2014-4525081,38,5,3,Office Supplies,Binders,33,33,15
AZ-2014-4525081,111,19,4,Office Supplies,Supplies,92,92,76
AZ-2014-4531843,16,2,1,Office Supplies,Fasteners,14,14,2
AZ-2014-4531843,49,20,5,Office Supplies,Labels,29,29,100
AZ-2014-4571075,54,20,4,Office Supplies,Envelopes,34,34,80
AZ-2014-4571565,468,57,2,Technology,Machines,411,411,114
AZ-2014-4591984,185,42,5,Office Supplies,Envelopes,143,143,210
AZ-2014-4591984,349,12,8,Office Supplies,Storage,337,337,96
AZ-2014-462189,846,56,3,Technology,Machines,790,790,168
AZ-2014-4622829,550,60,5,Furniture,Furnishings,490,490,300
AZ-2014-4622829,103,18,2,Office Supplies,Art,85,85,36
AZ-2014-4622829,281,129,9,Office Supplies,Envelopes,46,152,1161
AZ-2014-4622829,33,14,4,Office Supplies,Fasteners,19,19,56
AZ-2014-4622829,109,-33,1,Technology,Phones,142,142,-33
AZ-2014-4634987,747,-269,3,Office Supplies,Appliances,1016,1016,-807
AZ-2014-4634987,29,-4,5,Office Supplies,Fasteners,33,33,-20
AZ-2014-4645148,54,1,2,Office Supplies,Storage,53,53,2
AZ-2014-4649759,40,13,4,Office Supplies,Labels,27,27,52
AZ-2014-4649759,27,6,2,Office Supplies,Paper,21,21,12
AZ-2014-4651248,174,9,1,Furniture,Chairs,165,165,9
AZ-2014-4655935,207,77,4,Office Supplies,Art,130,130,308
AZ-2014-4660406,71,18,3,Office Supplies,Supplies,53,53,54
AZ-2014-4668799,504,116,3,Furniture,Bookcases,388,388,348
AZ-2014-4668799,107,9,2,Office Supplies,Art,98,98,18
AZ-2014-4668799,5,1,1,Office Supplies,Binders,4,4,1
AZ-2014-4668799,1158,232,9,Technology,Copiers,926,926,2088
AZ-2014-4668799,373,30,5,Technology,Machines,343,343,150
AZ-2014-4679554,104,27,4,Office Supplies,Art,77,77,108
AZ-2014-4687220,407,139,2,Technology,Copiers,268,268,278
AZ-2014-4696834,137,22,3,Office Supplies,Art,115,115,66
AZ-2014-4696834,51,23,4,Office Supplies,Binders,28,28,92
AZ-2014-4696834,2671,133,7,Technology,Phones,2538,2538,931
AZ-2014-4698064,98,39,2,Office Supplies,Binders,59,59,78
AZ-2014-4704527,331,29,9,Office Supplies,Art,148,302,261
AZ-2014-4704527,38,11,3,Office Supplies,Labels,27,27,33
AZ-2014-4704527,22,7,1,Office Supplies,Supplies,15,15,7
AZ-2014-4707297,105,43,4,Office Supplies,Art,62,62,172
AZ-2014-4709921,110,12,7,Office Supplies,Art,98,98,84
AZ-2014-4709921,536,42,3,Office Supplies,Storage,494,494,126
AZ-2014-4714590,1078,323,2,Office Supplies,Appliances,755,755,646
AZ-2014-4714590,385,50,3,Technology,Copiers,335,335,150
AZ-2014-4722343,31,13,3,Office Supplies,Fasteners,18,18,39
AZ-2014-4722343,63,1,4,Office Supplies,Storage,62,62,4
AZ-2014-4722343,297,52,2,Technology,Phones,245,245,104
AZ-2014-4726682,71,11,4,Office Supplies,Art,10,60,44
AZ-2014-4726682,122,43,7,Office Supplies,Envelopes,79,79,301
AZ-2014-4726682,294,88,6,Office Supplies,Storage,206,206,528
AZ-2014-4726682,59,5,2,Technology,Accessories,54,54,10
AZ-2014-4740053,1518,253,3,Office Supplies,Appliances,1265,1265,759
AZ-2014-4740053,21,6,2,Office Supplies,Fasteners,15,15,12
AZ-2014-4756753,377,49,3,Furniture,Bookcases,328,328,147
AZ-2014-4756753,152,50,6,Office Supplies,Art,102,102,300
AZ-2014-4764451,407,140,8,Office Supplies,Art,250,267,1120
AZ-2014-4789346,100,16,2,Furniture,Furnishings,84,84,32
AZ-2014-4803875,81,-44,3,Office Supplies,Appliances,125,125,-132
AZ-2014-4803875,657,-66,9,Technology,Phones,723,723,-594
AZ-2014-4825277,77,15,6,Office Supplies,Binders,14,62,90
AZ-2014-4825277,30,15,1,Office Supplies,Envelopes,15,15,15
AZ-2014-4825277,2097,189,8,Technology,Copiers,1908,1908,1512
AZ-2014-4842242,2553,843,7,Furniture,Bookcases,1710,1710,5901
AZ-2014-4842242,31,5,2,Office Supplies,Art,26,26,10
AZ-2014-4843798,85,18,3,Office Supplies,Binders,67,67,54
AZ-2014-4843798,485,56,6,Office Supplies,Storage,429,429,336
AZ-2014-4865312,17,7,3,Office Supplies,Binders,10,10,21
AZ-2014-4865312,100,25,6,Office Supplies,Fasteners,75,75,150
AZ-2014-4871918,125,49,1,Furniture,Bookcases,76,76,49
AZ-2014-4871918,11,5,1,Office Supplies,Fasteners,6,6,5
AZ-2014-4892329,131,27,4,Office Supplies,Paper,104,104,108
AZ-2014-4898591,34,9,3,Office Supplies,Binders,25,25,27
AZ-2014-4923095,2292,-1128,7,Furniture,Tables,3420,3420,-7896
AZ-2014-4923095,67,16,6,Office Supplies,Art,51,51,96
AZ-2014-49399,543,26,1,Technology,Phones,517,517,26
AZ-2014-494283,25,1,1,Office Supplies,Envelopes,24,24,1
AZ-2014-494283,190,15,4,Office Supplies,Storage,175,175,60
AZ-2014-4950235,135,36,2,Technology,Machines,99,99,72
AZ-2014-4979219,60,11,2,Office Supplies,Binders,49,49,22
AZ-2014-4983887,1578,131,11,Office Supplies,Appliances,1045,1447,1441
AZ-2014-4983887,96,35,3,Office Supplies,Binders,61,61,105
AZ-2014-4983887,45,16,4,Office Supplies,Supplies,29,29,64
AZ-2014-4983887,2070,83,8,Technology,Accessories,1987,1987,664
AZ-2014-4986921,820,38,5,Technology,Copiers,782,782,190
AZ-2014-4986921,4877,746,9,Technology,Phones,4131,4131,6714
AZ-2014-4987937,107,9,2,Office Supplies,Art,98,98,18
AZ-2014-4990754,27,13,2,Office Supplies,Labels,14,14,26
AZ-2014-4993399,39,0,5,Office Supplies,Labels,39,39,0
AZ-2014-5010364,71,1,3,Office Supplies,Art,70,70,3
AZ-2014-5012484,97,31,2,Office Supplies,Envelopes,66,66,62
AZ-2014-5047236,85,13,2,Furniture,Furnishings,72,72,26
AZ-2014-5058573,1637,91,5,Furniture,Bookcases,1546,1546,455
AZ-2014-5058573,413,-46,1,Furniture,Chairs,459,459,-46
AZ-2014-5058573,555,142,2,Office Supplies,Appliances,413,413,284
AZ-2014-5058573,28,1,1,Office Supplies,Art,27,27,1
AZ-2014-507287,69,6,3,Office Supplies,Art,15,63,18
AZ-2014-507287,69,9,7,Office Supplies,Binders,7,60,63
AZ-2014-507287,84,28,2,Technology,Accessories,56,56,56
AZ-2014-507287,130,30,2,Technology,Phones,100,100,60
AZ-2014-5084567,19,4,1,Office Supplies,Fasteners,15,15,4
AZ-2014-5084567,130,13,3,Technology,Accessories,117,117,39
AZ-2014-5104048,45,-35,6,Office Supplies,Binders,80,80,-210
AZ-2014-5109192,101,29,2,Office Supplies,Art,72,72,58
AZ-2014-5109192,26,11,2,Office Supplies,Binders,15,15,22
AZ-2014-5151587,101,32,2,Office Supplies,Art,69,69,64
AZ-2014-5151587,360,148,1,Technology,Copiers,212,212,148
AZ-2014-5151973,35,18,2,Furniture,Furnishings,17,17,36
AZ-2014-5155500,56,8,2,Office Supplies,Paper,48,48,16
AZ-2014-5155500,565,57,4,Technology,Phones,508,508,228
AZ-2014-5157015,311,15,5,Office Supplies,Storage,296,296,75
AZ-2014-5157015,3201,1216,13,Technology,Accessories,1985,1985,15808
AZ-2014-5167139,25,-8,1,Office Supplies,Art,33,33,-8
AZ-2014-5174076,50,7,3,Office Supplies,Art,43,43,21
AZ-2014-5189158,251,78,5,Furniture,Furnishings,173,173,390
AZ-2014-5189158,386,93,2,Technology,Copiers,293,293,186
AZ-2014-5189353,397,179,2,Office Supplies,Storage,218,218,358
AZ-2014-5196501,43,17,4,Office Supplies,Labels,26,26,68
AZ-2014-5202108,203,43,3,Office Supplies,Storage,13,160,129
AZ-2014-5210235,104,37,2,Furniture,Furnishings,67,67,74
AZ-2014-5226106,261,70,10,Office Supplies,Art,100,191,700
AZ-2014-5226106,35,16,4,Office Supplies,Labels,19,19,64
AZ-2014-5226106,640,288,2,Technology,Copiers,352,352,576
AZ-2014-5228686,250,75,4,Office Supplies,Storage,175,175,300
AZ-2014-522884,195,62,4,Office Supplies,Envelopes,133,133,248
AZ-2014-522884,1591,509,5,Technology,Copiers,1082,1082,2545
AZ-2014-526283,148,24,3,Office Supplies,Art,124,124,72
AZ-2014-526283,73,5,1,Technology,Machines,68,68,5
AZ-2014-5282151,1240,223,3,Furniture,Bookcases,1017,1017,669
AZ-2014-5282151,100,28,2,Office Supplies,Binders,72,72,56
AZ-2014-5282151,112,24,3,Office Supplies,Envelopes,88,88,72
AZ-2014-5282151,62,12,5,Office Supplies,Fasteners,50,50,60
AZ-2014-5282151,49,19,8,Office Supplies,Labels,14,30,152
AZ-2014-5282151,405,105,7,Office Supplies,Storage,300,300,735
AZ-2014-5282151,730,365,3,Technology,Copiers,365,365,1095
AZ-2014-5282151,1503,296,7,Technology,Machines,559,1207,2072
AZ-2014-5289299,37,12,7,Office Supplies,Binders,11,25,84
AZ-2014-5289299,19,1,2,Office Supplies,Labels,18,18,2
AZ-2014-5295692,18,4,3,Office Supplies,Envelopes,14,14,12
AZ-2014-5295692,54,13,2,Office Supplies,Supplies,41,41,26
AZ-2014-5295692,93,31,3,Technology,Accessories,62,62,93
AZ-2014-5295692,596,101,8,Technology,Phones,495,495,808
AZ-2014-5299088,53,11,3,Office Supplies,Paper,42,42,33
AZ-2014-532333,578,191,3,Technology,Copiers,387,387,573
AZ-2014-5324394,204,94,4,Office Supplies,Binders,110,110,376
AZ-2014-533150,916,81,6,Technology,Phones,835,835,486
AZ-2014-5335130,80,12,7,Office Supplies,Fasteners,68,68,84
AZ-2014-5335564,343,31,7,Furniture,Furnishings,312,312,217
AZ-2014-5335564,38,9,2,Office Supplies,Art,29,29,18
AZ-2014-5335564,574,270,3,Technology,Copiers,304,304,810
AZ-2014-5363417,429,17,3,Furniture,Chairs,412,412,51
AZ-2014-5363417,21,1,2,Office Supplies,Labels,20,20,2
AZ-2014-5363417,47,20,1,Technology,Accessories,27,27,20
AZ-2014-5374456,146,42,5,Office Supplies,Binders,104,104,210
AZ-2014-5374456,97,-45,3,Office Supplies,Storage,142,142,-135
AZ-2014-5388375,52,20,1,Office Supplies,Storage,32,32,20
AZ-2014-5388375,131,45,2,Technology,Machines,86,86,90
AZ-2014-538841,107,23,5,Office Supplies,Art,26,84,115
AZ-2014-5406401,611,170,15,Office Supplies,Art,296,441,2550
AZ-2014-5406401,646,46,2,Technology,Copiers,600,600,92
AZ-2014-5406401,318,105,3,Technology,Phones,213,213,315
AZ-2014-5408556,191,54,8,Furniture,Furnishings,137,137,432
AZ-2014-5410108,67,-67,6,Office Supplies,Art,134,134,-402
AZ-2014-5418007,62,16,5,Office Supplies,Paper,46,46,80
AZ-2014-5419885,54,4,1,Office Supplies,Art,50,50,4
AZ-2014-5419885,92,26,3,Office Supplies,Binders,66,66,78
AZ-2014-5426715,120,6,5,Office Supplies,Paper,114,114,30
AZ-2014-5429592,32,12,2,Office Supplies,Art,20,20,24
AZ-2014-5438822,142,3,6,Office Supplies,Supplies,139,139,18
AZ-2014-5444543,90,39,4,Office Supplies,Paper,51,51,156
AZ-2014-5446211,54,12,1,Office Supplies,Art,42,42,12
AZ-2014-5463403,51,3,7,Office Supplies,Labels,48,48,21
AZ-2014-5473130,176,85,7,Office Supplies,Paper,91,91,595
AZ-2014-5479576,155,5,3,Office Supplies,Art,150,150,15
AZ-2014-5480991,56,27,8,Office Supplies,Binders,29,29,216
AZ-2014-5480991,49,24,3,Office Supplies,Fasteners,25,25,72
AZ-2014-5509537,31,6,2,Furniture,Furnishings,25,25,12
AZ-2014-551552,96,43,2,Office Supplies,Storage,53,53,86
AZ-2014-551552,1157,220,6,Technology,Copiers,937,937,1320
AZ-2014-5519564,484,58,9,Office Supplies,Storage,426,426,522
AZ-2014-5519564,598,101,7,Technology,Accessories,497,497,707
AZ-2014-5528996,555,92,5,Technology,Phones,463,463,460
AZ-2014-5532037,93,44,2,Office Supplies,Art,49,49,88
AZ-2014-5532037,173,74,3,Technology,Accessories,99,99,222
AZ-2014-5538768,166,53,4,Technology,Accessories,113,113,212
AZ-2014-5541569,415,62,8,Office Supplies,Art,353,353,496
AZ-2014-5554789,82,39,7,Office Supplies,Labels,43,43,273
AZ-2014-5554789,219,90,3,Technology,Machines,129,129,270
AZ-2014-5560441,48,22,2,Office Supplies,Supplies,26,26,44
AZ-2014-5561990,73,31,1,Technology,Phones,42,42,31
AZ-2014-5567456,159,73,3,Office Supplies,Binders,86,86,219
AZ-2014-5567456,187,80,4,Office Supplies,Supplies,107,107,320
AZ-2014-5567456,191,90,1,Technology,Copiers,101,101,90
AZ-2014-5577510,575,45,8,Furniture,Chairs,530,530,360
AZ-2014-5584970,11,1,1,Office Supplies,Labels,10,10,1
AZ-2014-5593703,1579,614,4,Furniture,Bookcases,965,965,2456
AZ-2014-559431,127,10,3,Furniture,Chairs,117,117,30
AZ-2014-559431,661,119,6,Technology,Accessories,542,542,714
AZ-2014-559431,1400,353,11,Technology,Phones,195,1047,3883
AZ-2014-5598265,45,12,1,Office Supplies,Envelopes,33,33,12
AZ-2014-5598677,69,11,3,Office Supplies,Envelopes,58,58,33
AZ-2014-5598677,176,57,4,Technology,Machines,119,119,228
AZ-2014-5614288,134,-44,8,Furniture,Furnishings,178,178,-352
AZ-2014-5614288,324,37,8,Office Supplies,Binders,258,287,296
AZ-2014-5614288,40,2,1,Office Supplies,Envelopes,38,38,2
AZ-2014-5614288,44,5,4,Office Supplies,Labels,39,39,20
AZ-2014-561709,30,0,1,Office Supplies,Art,30,30,0
AZ-2014-561709,14,5,2,Office Supplies,Labels,9,9,10
AZ-2014-561709,677,-112,3,Technology,Machines,789,789,-336
AZ-2014-5623990,17,3,2,Office Supplies,Labels,14,14,6
AZ-2014-5624461,261,49,6,Office Supplies,Storage,212,212,294
AZ-2014-5629900,80,0,3,Office Supplies,Storage,80,80,0
AZ-2014-564669,627,301,5,Furniture,Bookcases,326,326,1505
AZ-2014-5667627,112,41,7,Office Supplies,Art,71,71,287
AZ-2014-5688152,271,73,6,Office Supplies,Envelopes,198,198,438
AZ-2014-5688152,49,16,1,Office Supplies,Storage,33,33,16
AZ-2014-5692945,226,7,7,Furniture,Furnishings,99,219,49
AZ-2014-5692945,371,124,3,Office Supplies,Storage,247,247,372
AZ-2014-5706621,184,64,3,Office Supplies,Appliances,120,120,192
AZ-2014-5722842,106,9,4,Office Supplies,Art,97,97,36
AZ-2014-5722842,28,12,3,Office Supplies,Binders,16,16,36
AZ-2014-5722842,22,10,3,Office Supplies,Envelopes,12,12,30
AZ-2014-5722842,46,20,4,Office Supplies,Fasteners,26,26,80
AZ-2014-5722842,40,13,3,Office Supplies,Paper,27,27,39
AZ-2014-5722987,287,66,6,Office Supplies,Envelopes,221,221,396
AZ-2014-5722987,71,26,3,Office Supplies,Paper,45,45,78
AZ-2014-5759830,28,0,3,Office Supplies,Labels,28,28,0
AZ-2014-5759981,47,16,2,Office Supplies,Art,31,31,32
AZ-2014-5765261,558,0,2,Office Supplies,Appliances,558,558,0
AZ-2014-5765261,25,12,2,Office Supplies,Binders,13,13,24
AZ-2014-5765261,158,32,6,Office Supplies,Paper,126,126,192
AZ-2014-5765261,127,41,3,Office Supplies,Storage,86,86,123
AZ-2014-5765261,133,39,3,Office Supplies,Supplies,94,94,117
AZ-2014-5778824,30,14,4,Office Supplies,Binders,16,16,56
AZ-2014-5778824,44,-3,1,Office Supplies,Storage,47,47,-3
AZ-2014-582693,450,140,3,Furniture,Chairs,310,310,420
AZ-2014-5827571,125,38,2,Office Supplies,Storage,87,87,76
AZ-2014-5829110,1517,575,10,Office Supplies,Storage,874,942,5750
AZ-2014-5836619,86,4,6,Office Supplies,Binders,82,82,24
AZ-2014-5836619,119,36,4,Office Supplies,Paper,83,83,144
AZ-2014-5838029,441,103,8,Office Supplies,Storage,338,338,824
AZ-2014-5838029,772,185,4,Technology,Copiers,587,587,740
AZ-2014-5845365,127,42,5,Office Supplies,Art,85,85,210
AZ-2014-5854917,758,126,4,Office Supplies,Storage,632,632,504
AZ-2014-5855020,284,100,2,Technology,Machines,184,184,200
AZ-2014-5856629,1217,304,7,Furniture,Bookcases,913,913,2128
AZ-2014-5856629,115,-158,5,Furniture,Chairs,273,273,-790
AZ-2014-5856629,146,19,3,Furniture,Furnishings,127,127,57
AZ-2014-5856629,49,0,4,Office Supplies,Art,49,49,0
AZ-2014-5856629,986,79,4,Technology,Accessories,907,907,316
AZ-2014-5857850,316,79,6,Furniture,Chairs,237,237,474
AZ-2014-5857850,1632,-505,6,Furniture,Tables,2137,2137,-3030
AZ-2014-5857850,133,0,3,Office Supplies,Envelopes,133,133,0
AZ-2014-586948,1101,319,9,Technology,Machines,782,782,2871
AZ-2014-5887026,1429,472,4,Technology,Copiers,957,957,1888
AZ-2014-5889242,50,16,2,Office Supplies,Art,34,34,32
AZ-2014-5889242,22,11,3,Office Supplies,Envelopes,11,11,33
AZ-2014-5889570,48,1,2,Office Supplies,Storage,47,47,2
AZ-2014-5901455,51,17,3,Office Supplies,Art,34,34,51
AZ-2014-5901455,71,28,2,Technology,Accessories,43,43,56
AZ-2014-5904203,18,6,2,Office Supplies,Labels,12,12,12
AZ-2014-5904203,735,131,4,Office Supplies,Storage,604,604,524
AZ-2014-5922257,131,4,5,Office Supplies,Art,127,127,20
AZ-2014-5922257,101,26,4,Office Supplies,Binders,75,75,104
AZ-2014-5927838,15,2,1,Office Supplies,Envelopes,13,13,2
AZ-2014-5931184,289,23,2,Furniture,Bookcases,266,266,46
AZ-2014-5931184,12,1,3,Office Supplies,Binders,11,11,3
AZ-2014-5931184,34,14,2,Office Supplies,Paper,20,20,28
AZ-2014-5931184,300,150,6,Office Supplies,Supplies,150,150,900
AZ-2014-5935860,225,42,3,Furniture,Chairs,183,183,126
AZ-2014-5935860,428,107,4,Furniture,Furnishings,321,321,428
AZ-2014-5935860,85,0,3,Office Supplies,Binders,85,85,0
AZ-2014-5952161,201,4,4,Technology,Machines,197,197,16
AZ-2014-5956672,49,19,4,Office Supplies,Envelopes,30,30,76
AZ-2014-5956672,527,227,2,Technology,Copiers,300,300,454
AZ-2014-5958332,41,9,3,Office Supplies,Fasteners,32,32,27
AZ-2014-5958487,106,2,4,Office Supplies,Art,104,104,8
AZ-2014-5960256,374,141,2,Office Supplies,Storage,233,233,282
AZ-2014-5960256,2305,922,9,Technology,Accessories,1383,1383,8298
AZ-2014-5969019,2135,21,8,Technology,Machines,2114,2114,168
AZ-2014-5973940,30,4,2,Office Supplies,Binders,26,26,8
AZ-2014-5976427,46,7,2,Office Supplies,Envelopes,39,39,14
AZ-2014-599049,19,8,2,Office Supplies,Binders,11,11,16
AZ-2014-599049,32,10,2,Office Supplies,Supplies,22,22,20
AZ-2014-6001342,8,1,2,Office Supplies,Binders,7,7,2
AZ-2014-6001342,27,1,4,Office Supplies,Labels,26,26,4
AZ-2014-6001342,146,20,3,Office Supplies,Paper,126,126,60
AZ-2014-6013408,339,61,2,Technology,Phones,278,278,122
AZ-2014-6017898,869,367,7,Technology,Phones,502,502,2569
AZ-2014-6019807,828,230,2,Furniture,Chairs,598,598,460
AZ-2014-6019807,34,10,2,Office Supplies,Paper,24,24,20
AZ-2014-6019807,72,16,2,Office Supplies,Supplies,56,56,32
AZ-2014-6019807,489,142,6,Technology,Accessories,347,347,852
AZ-2014-6019807,379,-13,3,Technology,Copiers,392,392,-39
AZ-2014-6031845,2366,552,5,Office Supplies,Appliances,1814,1814,2760
AZ-2014-6040640,835,267,5,Technology,Phones,568,568,1335
AZ-2014-6041195,207,37,4,Office Supplies,Binders,170,170,148
AZ-2014-6041399,9,3,1,Office Supplies,Labels,6,6,3
AZ-2014-604264,46,14,5,Office Supplies,Labels,32,32,70
AZ-2014-6047268,59,15,2,Office Supplies,Paper,44,44,30
AZ-2014-6052512,497,179,3,Furniture,Chairs,318,318,537
AZ-2014-6052512,96,48,5,Office Supplies,Fasteners,48,48,240
AZ-2014-6052512,409,86,3,Office Supplies,Storage,323,323,258
AZ-2014-6053931,82,8,3,Technology,Accessories,74,74,24
AZ-2014-6061991,185,-26,6,Furniture,Chairs,211,211,-156
AZ-2014-6061991,663,-212,5,Technology,Copiers,875,875,-1060
AZ-2014-6061991,671,-309,5,Technology,Machines,980,980,-1545
AZ-2014-6063209,264,-26,3,Office Supplies,Appliances,290,290,-78
AZ-2014-6063209,130,25,5,Office Supplies,Binders,85,105,125
AZ-2014-6063209,39,18,2,Office Supplies,Fasteners,21,21,36
AZ-2014-6084917,152,50,6,Office Supplies,Art,102,102,300
AZ-2014-6084917,6,1,1,Office Supplies,Envelopes,5,5,1
AZ-2014-6084917,45,9,3,Office Supplies,Fasteners,36,36,27
AZ-2014-6084917,103,46,2,Office Supplies,Storage,57,57,92
AZ-2014-6084917,140,56,4,Office Supplies,Supplies,84,84,224
AZ-2014-6084917,88,11,3,Technology,Accessories,77,77,33
AZ-2014-6084917,451,25,3,Technology,Phones,426,426,75
AZ-2014-6085803,49,5,4,Office Supplies,Binders,44,44,20
AZ-2014-6085803,148,25,3,Office Supplies,Storage,123,123,75
AZ-2014-6094082,81,41,5,Office Supplies,Fasteners,40,40,205
AZ-2014-6097969,852,51,5,Furniture,Bookcases,801,801,255
AZ-2014-6097969,492,187,2,Technology,Accessories,305,305,374
AZ-2014-6107524,238,91,6,Office Supplies,Art,58,147,546
AZ-2014-6107524,29,10,4,Office Supplies,Binders,19,19,40
AZ-2014-6107524,59,10,4,Office Supplies,Fasteners,49,49,40
AZ-2014-6107524,97,14,2,Office Supplies,Paper,83,83,28
AZ-2014-6107524,33,-1,1,Office Supplies,Storage,34,34,-1
AZ-2014-6107524,2847,712,8,Technology,Copiers,2135,2135,5696
AZ-2014-6147970,27,4,1,Office Supplies,Binders,23,23,4
AZ-2014-6147970,139,14,3,Office Supplies,Envelopes,125,125,42
AZ-2014-6155335,180,0,8,Office Supplies,Art,180,180,0
AZ-2014-6155335,11,5,2,Office Supplies,Binders,6,6,10
AZ-2014-6155335,59,24,6,Office Supplies,Envelopes,35,35,144
AZ-2014-6158544,40,10,2,Office Supplies,Art,30,30,20
AZ-2014-6165036,311,40,1,Technology,Machines,271,271,40
AZ-2014-6185153,46,13,3,Office Supplies,Binders,33,33,39
AZ-2014-6197467,119,56,7,Office Supplies,Storage,63,63,392
AZ-2014-6207132,25,2,2,Office Supplies,Binders,23,23,4
AZ-2014-6214587,43,17,2,Office Supplies,Paper,26,26,34
AZ-2014-6214587,762,101,6,Technology,Copiers,661,661,606
AZ-2014-6229450,40,17,2,Office Supplies,Art,23,23,34
AZ-2014-6229450,132,-10,3,Office Supplies,Storage,142,142,-30
AZ-2014-6235976,1487,624,3,Office Supplies,Appliances,863,863,1872
AZ-2014-6244900,86,22,2,Office Supplies,Storage,64,64,44
AZ-2014-6246493,95,5,2,Office Supplies,Art,90,90,10
AZ-2014-6246493,43,8,3,Office Supplies,Fasteners,35,35,24
AZ-2014-6246493,145,16,3,Office Supplies,Paper,129,129,48
AZ-2014-6246493,34,3,3,Office Supplies,Storage,31,31,9
AZ-2014-6246493,188,23,3,Technology,Accessories,137,165,69
AZ-2014-6246493,209,-63,4,Technology,Machines,272,272,-252
AZ-2014-6249694,79,33,4,Office Supplies,Art,46,46,132
AZ-2014-6249694,24,11,3,Office Supplies,Binders,13,13,33
AZ-2014-6249694,637,50,5,Office Supplies,Storage,587,587,250
AZ-2014-6264387,359,-338,5,Furniture,Bookcases,697,697,-1690
AZ-2014-6264387,93,-84,3,Office Supplies,Storage,177,177,-252
AZ-2014-6264387,169,0,3,Technology,Accessories,169,169,0
AZ-2014-6271247,137,63,3,Office Supplies,Art,74,74,189
AZ-2014-6271247,18,3,2,Office Supplies,Binders,15,15,6
AZ-2014-6271247,109,35,6,Office Supplies,Paper,74,74,210
AZ-2014-6273241,557,111,2,Technology,Machines,446,446,222
AZ-2014-6299049,44,20,2,Office Supplies,Paper,24,24,40
AZ-2014-6301419,450,190,4,Furniture,Bookcases,260,260,760
AZ-2014-6301419,62,11,7,Office Supplies,Binders,51,51,77
AZ-2014-6301419,17,8,2,Office Supplies,Labels,9,9,16
AZ-2014-6304263,19,4,2,Office Supplies,Storage,15,15,8
AZ-2014-6305127,60,13,2,Office Supplies,Paper,47,47,26
AZ-2014-6308636,91,22,2,Office Supplies,Art,69,69,44
AZ-2014-6308636,133,46,5,Office Supplies,Supplies,87,87,230
AZ-2014-6326220,34,12,2,Office Supplies,Art,22,22,24
AZ-2014-6340236,57,21,4,Office Supplies,Fasteners,36,36,84
AZ-2014-6356102,290,110,9,Office Supplies,Art,180,180,990
AZ-2014-6356102,122,11,4,Office Supplies,Binders,111,111,44
AZ-2014-6356102,29,9,3,Office Supplies,Storage,20,20,27
AZ-2014-6356102,1514,742,4,Technology,Copiers,772,772,2968
AZ-2014-6360683,37,17,3,Office Supplies,Binders,20,20,51
AZ-2014-6360899,582,262,5,Furniture,Furnishings,320,320,1310
AZ-2014-6360899,75,29,1,Office Supplies,Appliances,46,46,29
AZ-2014-6360899,35,11,5,Office Supplies,Binders,7,24,55
AZ-2014-6360899,313,44,3,Technology,Machines,269,269,132
AZ-2014-6368939,54,12,4,Office Supplies,Supplies,42,42,48
AZ-2014-6379288,55,18,2,Office Supplies,Envelopes,37,37,36
AZ-2014-6389131,67,2,4,Office Supplies,Paper,65,65,8
AZ-2014-6389131,193,33,5,Technology,Accessories,160,160,165
AZ-2014-6391866,618,27,4,Furniture,Bookcases,591,591,108
AZ-2014-6391866,53,2,4,Office Supplies,Binders,51,51,8
AZ-2014-6391866,1120,199,6,Office Supplies,Storage,921,921,1194
AZ-2014-6391866,1137,-14,7,Technology,Copiers,1151,1151,-98
AZ-2014-6397741,146,19,5,Office Supplies,Art,127,127,95
AZ-2014-6397741,86,22,2,Office Supplies,Storage,64,64,44
AZ-2014-6401061,61,3,4,Office Supplies,Binders,58,58,12
AZ-2014-6401061,122,38,6,Office Supplies,Paper,84,84,228
AZ-2014-6401061,22,0,2,Office Supplies,Storage,22,22,0
AZ-2014-6407661,75,2,5,Office Supplies,Fasteners,73,73,10
AZ-2014-6408237,107,-59,6,Office Supplies,Art,84,166,-354
AZ-2014-6408237,241,-77,4,Technology,Machines,318,318,-308
AZ-2014-641146,109,52,2,Office Supplies,Art,57,57,104
AZ-2014-641146,27,8,2,Office Supplies,Paper,19,19,16
AZ-2014-6417679,642,180,5,Office Supplies,Storage,462,462,900
AZ-2014-6423763,659,-37,2,Furniture,Bookcases,696,696,-74
AZ-2014-6423763,224,87,3,Office Supplies,Appliances,137,137,261
AZ-2014-6423763,212,97,7,Office Supplies,Binders,115,115,679
AZ-2014-6423763,20,6,1,Office Supplies,Paper,14,14,6
AZ-2014-6423763,382,68,3,Office Supplies,Storage,314,314,204
AZ-2014-6423763,508,203,2,Technology,Accessories,305,305,406
AZ-2014-6423763,1171,-56,4,Technology,Copiers,1033,1227,-224
AZ-2014-6427379,54,8,4,Office Supplies,Paper,46,46,32
AZ-2014-6429468,206,18,4,Office Supplies,Binders,188,188,72
AZ-2014-6429468,736,346,5,Technology,Copiers,390,390,1730
AZ-2014-6451890,213,-145,3,Furniture,Bookcases,358,358,-435
AZ-2014-6451890,19,-18,4,Office Supplies,Envelopes,37,37,-72
AZ-2014-6453341,132,20,4,Office Supplies,Binders,90,112,80
AZ-2014-6453341,220,40,2,Technology,Accessories,180,180,80
AZ-2014-6477857,15,6,2,Office Supplies,Binders,9,9,12
AZ-2014-6484153,33,9,2,Office Supplies,Binders,24,24,18
AZ-2014-6484153,424,161,2,Office Supplies,Storage,263,263,322
AZ-2014-6484153,391,90,6,Technology,Phones,301,301,540
AZ-2014-6494772,70,24,3,Office Supplies,Art,46,46,72
AZ-2014-6494772,47,20,7,Office Supplies,Binders,27,27,140
AZ-2014-6497288,57,7,2,Office Supplies,Supplies,50,50,14
AZ-2014-6500467,671,114,9,Technology,Phones,557,557,1026
AZ-2014-651851,1218,420,8,Furniture,Bookcases,798,798,3360
AZ-2014-6526295,43,11,1,Office Supplies,Storage,32,32,11
AZ-2014-6530154,5729,64,14,Furniture,Chairs,5665,5665,896
AZ-2014-6530154,94,27,2,Office Supplies,Paper,67,67,54
AZ-2014-6530154,213,4,14,Office Supplies,Supplies,209,209,56
AZ-2014-6530154,250,-12,2,Technology,Copiers,262,262,-24
AZ-2014-6537657,227,48,5,Office Supplies,Art,179,179,240
AZ-2014-6552559,294,34,8,Office Supplies,Art,127,260,272
AZ-2014-6552559,559,174,2,Technology,Machines,385,385,348
AZ-2014-655850,139,36,3,Office Supplies,Art,103,103,108
AZ-2014-6559589,120,1,1,Furniture,Chairs,119,119,1
AZ-2014-6559589,162,55,3,Office Supplies,Art,107,107,165
AZ-2014-6559589,246,98,5,Office Supplies,Binders,148,148,490
AZ-2014-6559589,88,20,2,Office Supplies,Storage,68,68,40
AZ-2014-6559589,88,19,2,Office Supplies,Supplies,69,69,38
AZ-2014-6559589,139,21,3,Technology,Accessories,118,118,63
AZ-2014-656568,85,2,6,Office Supplies,Art,83,83,12
AZ-2014-656568,27,6,3,Office Supplies,Labels,21,21,18
AZ-2014-6597356,594,89,3,Furniture,Bookcases,505,505,267
AZ-2014-6619612,246,61,2,Furniture,Bookcases,185,185,122
AZ-2014-6619612,425,208,7,Office Supplies,Storage,217,217,1456
AZ-2014-6619612,93,31,3,Technology,Accessories,62,62,93
AZ-2014-6621179,17,1,2,Office Supplies,Labels,16,16,2
AZ-2014-6626996,774,170,3,Technology,Accessories,604,604,510
AZ-2014-6629970,25,7,2,Office Supplies,Art,18,18,14
AZ-2014-6630320,15,1,1,Office Supplies,Supplies,14,14,1
AZ-2014-6630720,148,23,4,Office Supplies,Envelopes,125,125,92
AZ-2014-6634288,145,0,3,Office Supplies,Storage,145,145,0
AZ-2014-663950,101,16,4,Office Supplies,Paper,85,85,64
AZ-2014-6650288,78,28,6,Office Supplies,Envelopes,50,50,168
AZ-2014-6660694,1345,269,10,Furniture,Bookcases,481,1076,2690
AZ-2014-6660694,296,72,7,Office Supplies,Art,58,224,504
AZ-2014-6660694,85,24,10,Office Supplies,Binders,61,61,240
AZ-2014-6660694,382,119,2,Office Supplies,Storage,263,263,238
AZ-2014-6660694,490,88,2,Technology,Accessories,402,402,176
AZ-2014-6660694,1337,147,7,Technology,Copiers,1190,1190,1029
AZ-2014-6660694,600,102,5,Technology,Machines,498,498,510
AZ-2014-6672718,184,85,6,Office Supplies,Paper,99,99,510
AZ-2014-6684100,382,92,2,Technology,Copiers,290,290,184
AZ-2014-6685609,284,44,6,Office Supplies,Binders,240,240,264
AZ-2014-6710580,38,9,2,Office Supplies,Art,29,29,18
AZ-2014-6714214,32,6,3,Office Supplies,Supplies,26,26,18
AZ-2014-6715732,79,32,3,Office Supplies,Storage,47,47,96
AZ-2014-6745557,166,27,2,Technology,Accessories,139,139,54
AZ-2014-6752912,401,13,6,Furniture,Chairs,388,388,78
AZ-2014-6752912,1461,202,5,Furniture,Tables,1259,1259,1010
AZ-2014-6752912,1104,209,4,Office Supplies,Appliances,895,895,836
AZ-2014-6752912,100,28,2,Office Supplies,Binders,72,72,56
AZ-2014-6752912,325,32,7,Office Supplies,Paper,293,293,224
AZ-2014-6752912,169,55,4,Office Supplies,Storage,114,114,220
AZ-2014-6752912,487,143,4,Technology,Phones,344,344,572
AZ-2014-6764855,27,5,1,Office Supplies,Art,22,22,5
AZ-2014-6764855,32,3,8,Office Supplies,Binders,29,29,24
AZ-2014-6764855,55,12,5,Office Supplies,Labels,43,43,60
AZ-2014-6764855,163,81,2,Technology,Accessories,82,82,162
AZ-2014-6791682,302,75,6,Furniture,Furnishings,227,227,450
AZ-2014-6791682,376,0,7,Office Supplies,Art,376,376,0
AZ-2014-6791682,179,77,1,Office Supplies,Storage,102,102,77
AZ-2014-6797948,122,50,7,Office Supplies,Art,72,72,350
AZ-2014-6797948,28,10,3,Office Supplies,Labels,18,18,30
AZ-2014-6819161,176,-28,5,Furniture,Furnishings,204,204,-140
AZ-2014-6819161,221,63,7,Office Supplies,Art,21,158,441
AZ-2014-6819161,141,33,11,Office Supplies,Binders,34,108,363
AZ-2014-6819161,30,12,3,Office Supplies,Labels,18,18,36
AZ-2014-6824092,833,93,3,Office Supplies,Appliances,740,740,279
AZ-2014-6826926,113,24,4,Office Supplies,Binders,89,89,96
AZ-2014-6846105,38,9,2,Office Supplies,Art,29,29,18
AZ-2014-6852379,83,34,5,Office Supplies,Supplies,49,49,170
AZ-2014-6854187,30,6,1,Office Supplies,Paper,24,24,6
AZ-2014-6875422,52,14,2,Office Supplies,Art,38,38,28
AZ-2014-6878748,130,61,3,Office Supplies,Supplies,69,69,183
AZ-2014-688313,41,19,2,Office Supplies,Paper,22,22,38
AZ-2014-6883963,341,44,7,Furniture,Furnishings,297,297,308
AZ-2014-6883963,171,68,7,Office Supplies,Art,103,103,476
AZ-2014-6884762,369,15,3,Technology,Machines,354,354,45
AZ-2014-6896726,291,119,11,Office Supplies,Storage,172,172,1309
AZ-2014-6896726,520,151,3,Technology,Phones,369,369,453
AZ-2014-6915689,143,32,1,Furniture,Bookcases,111,111,32
AZ-2014-6915689,111,35,5,Office Supplies,Supplies,76,76,175
AZ-2014-6915689,425,183,5,Technology,Accessories,242,242,915
AZ-2014-6926624,774,170,3,Technology,Accessories,604,604,510
AZ-2014-6937153,47,15,5,Office Supplies,Storage,32,32,75
AZ-2014-6943105,67,9,4,Office Supplies,Fasteners,58,58,36
AZ-2014-6950700,291,93,2,Technology,Copiers,198,198,186
AZ-2014-6975089,89,36,3,Office Supplies,Supplies,53,53,108
AZ-2014-7010933,50,25,5,Office Supplies,Art,25,25,125
AZ-2014-7020120,11,5,1,Office Supplies,Labels,6,6,5
AZ-2014-7020120,221,35,4,Technology,Accessories,186,186,140
AZ-2014-7029389,92,5,6,Office Supplies,Binders,87,87,30
AZ-2014-7035422,21,10,1,Office Supplies,Paper,11,11,10
AZ-2014-7040665,414,45,13,Office Supplies,Art,38,369,585
AZ-2014-7040665,296,95,14,Office Supplies,Binders,22,201,1330
AZ-2014-7040665,25,2,3,Office Supplies,Envelopes,23,23,6
AZ-2014-7040665,54,8,4,Office Supplies,Paper,46,46,32
AZ-2014-7040665,77,36,2,Office Supplies,Supplies,41,41,72
AZ-2014-7040665,115,0,1,Technology,Accessories,115,115,0
AZ-2014-7040665,1272,547,2,Technology,Phones,725,725,1094
AZ-2014-7046345,1117,447,10,Furniture,Bookcases,670,670,4470
AZ-2014-7046345,29,0,3,Furniture,Furnishings,29,29,0
AZ-2014-7046345,66,22,3,Office Supplies,Art,44,44,66
AZ-2014-7090421,21,-12,3,Office Supplies,Binders,33,33,-36
AZ-2014-7090421,1824,-1303,8,Technology,Phones,3127,3127,-10424
AZ-2014-7090989,122,59,7,Furniture,Furnishings,63,63,413
AZ-2014-7090989,49,21,1,Office Supplies,Art,28,28,21
AZ-2014-7106624,78,7,1,Furniture,Chairs,71,71,7
AZ-2014-7106624,326,107,3,Furniture,Furnishings,219,219,321
AZ-2014-7106624,61,8,4,Office Supplies,Binders,53,53,32
AZ-2014-7106624,585,175,13,Office Supplies,Paper,410,410,2275
AZ-2014-7106624,319,102,6,Technology,Accessories,217,217,612
AZ-2014-7108585,202,4,4,Office Supplies,Binders,198,198,16
AZ-2014-7108585,563,48,6,Technology,Machines,368,515,288
AZ-2014-7108970,684,136,12,Furniture,Chairs,309,548,1632
AZ-2014-7108970,128,55,1,Office Supplies,Storage,73,73,55
AZ-2014-7108970,74,9,3,Office Supplies,Supplies,65,65,27
AZ-2014-7114093,29,10,3,Office Supplies,Labels,19,19,30
AZ-2014-7123032,93,44,2,Office Supplies,Art,49,49,88
AZ-2014-7123032,21,8,2,Office Supplies,Storage,13,13,16
AZ-2014-7142751,176,-13,5,Furniture,Furnishings,189,189,-65
AZ-2014-7142751,55,3,3,Office Supplies,Paper,52,52,9
AZ-2014-7156078,18,2,3,Office Supplies,Binders,16,16,6
AZ-2014-7156514,85,13,2,Office Supplies,Supplies,72,72,26
AZ-2014-7174058,29,3,2,Office Supplies,Art,26,26,6
AZ-2014-7187125,195,12,9,Office Supplies,Supplies,183,183,108
AZ-2014-7187125,527,26,3,Technology,Machines,501,501,78
AZ-2014-7188993,10,-1,1,Office Supplies,Storage,11,11,-1
AZ-2014-7188993,285,128,2,Technology,Copiers,157,157,256
AZ-2014-7189649,311,72,2,Furniture,Bookcases,239,239,144
AZ-2014-7189649,22,4,1,Office Supplies,Art,18,18,4
AZ-2014-7189649,206,51,4,Office Supplies,Binders,155,155,204
AZ-2014-7189649,57,24,5,Office Supplies,Fasteners,33,33,120
AZ-2014-7220794,87,10,3,Office Supplies,Art,77,77,30
AZ-2014-7220794,1301,573,5,Technology,Accessories,728,728,2865
AZ-2014-7225808,1745,122,2,Furniture,Tables,1623,1623,244
AZ-2014-7225808,17,2,2,Office Supplies,Labels,15,15,4
AZ-2014-7225808,147,44,3,Office Supplies,Storage,103,103,132
AZ-2014-7225808,162,73,2,Technology,Machines,89,89,146
AZ-2014-7242450,766,54,12,Furniture,Furnishings,639,712,648
AZ-2014-7242450,79,16,3,Office Supplies,Paper,63,63,48
AZ-2014-7242450,498,-116,4,Office Supplies,Storage,614,614,-464
AZ-2014-7247090,315,-8,3,Furniture,Chairs,323,323,-24
AZ-2014-7247090,128,47,4,Office Supplies,Binders,81,81,188
AZ-2014-7256409,113,28,2,Office Supplies,Storage,85,85,56
AZ-2014-7265288,141,7,7,Office Supplies,Storage,134,134,49
AZ-2014-7267065,71,19,3,Office Supplies,Paper,52,52,57
AZ-2014-7267676,276,52,5,Office Supplies,Storage,224,224,260
AZ-2014-727040,80,22,3,Office Supplies,Art,58,58,66
AZ-2014-7287251,50,9,6,Office Supplies,Labels,41,41,54
AZ-2014-729084,149,17,4,Furniture,Furnishings,132,132,68
AZ-2014-729084,8,2,2,Office Supplies,Labels,6,6,4
AZ-2014-7306180,597,93,4,Furniture,Chairs,504,504,372
AZ-2014-7306180,13,0,2,Office Supplies,Binders,13,13,0
AZ-2014-7329559,109,40,1,Furniture,Furnishings,69,69,40
AZ-2014-7329559,43,9,4,Office Supplies,Labels,34,34,36
AZ-2014-7329559,676,151,3,Technology,Copiers,525,525,453
AZ-2014-7363418,222,74,5,Office Supplies,Binders,148,148,370
AZ-2014-7363418,215,-30,2,Office Supplies,Storage,245,245,-60
AZ-2014-7367498,223,62,7,Office Supplies,Supplies,161,161,434
AZ-2014-7367498,770,323,3,Technology,Accessories,447,447,969
AZ-2014-7380286,129,11,2,Technology,Phones,118,118,22
AZ-2014-7384314,352,74,8,Office Supplies,Art,278,278,592
AZ-2014-7388956,50,-28,5,Furniture,Furnishings,78,78,-140
AZ-2014-7388956,119,-82,5,Office Supplies,Art,43,201,-410
AZ-2014-7388956,152,-3,5,Office Supplies,Storage,155,155,-15
AZ-2014-7388956,51,-49,2,Technology,Machines,100,100,-98
AZ-2014-739354,48,15,1,Office Supplies,Binders,33,33,15
AZ-2014-7397204,2292,127,7,Furniture,Bookcases,2165,2165,889
AZ-2014-7400496,16,6,3,Office Supplies,Binders,10,10,18
AZ-2014-7400496,231,99,2,Technology,Machines,132,132,198
AZ-2014-741158,47,1,2,Office Supplies,Art,46,46,2
AZ-2014-741158,18,4,1,Office Supplies,Storage,14,14,4
AZ-2014-7413278,217,72,2,Furniture,Furnishings,145,145,144
AZ-2014-7413278,286,140,6,Office Supplies,Supplies,146,146,840
AZ-2014-7413278,333,50,2,Technology,Phones,283,283,100
AZ-2014-7416333,31,2,2,Office Supplies,Binders,29,29,4
AZ-2014-7416402,62,6,6,Office Supplies,Labels,56,56,36
AZ-2014-7427594,1314,342,3,Furniture,Bookcases,972,972,1026
AZ-2014-7437787,422,58,11,Furniture,Furnishings,195,364,638
AZ-2014-7437787,173,86,1,Technology,Copiers,87,87,86
AZ-2014-7437787,196,-7,5,Technology,Phones,203,203,-35
AZ-2014-7447666,4363,305,5,Furniture,Tables,4058,4058,1525
AZ-2014-7447666,414,199,3,Technology,Phones,215,215,597
AZ-2014-7450631,610,208,3,Technology,Copiers,402,402,624
AZ-2014-7453944,44,8,2,Office Supplies,Art,36,36,16
AZ-2014-7469338,141,41,3,Office Supplies,Supplies,100,100,123
AZ-2014-752622,90,30,2,Furniture,Chairs,60,60,60
AZ-2014-752622,13,5,2,Office Supplies,Binders,8,8,10
AZ-2014-7526286,330,81,1,Furniture,Bookcases,249,249,81
AZ-2014-7526286,338,41,7,Office Supplies,Binders,297,297,287
AZ-2014-7526286,71,32,3,Office Supplies,Storage,39,39,96
AZ-2014-7526286,188,13,7,Office Supplies,Supplies,175,175,91
AZ-2014-7540023,42,15,1,Technology,Accessories,27,27,15
AZ-2014-7552735,10,5,1,Office Supplies,Art,5,5,5
AZ-2014-7559848,44,14,3,Office Supplies,Binders,30,30,42
AZ-2014-756508,88,11,7,Office Supplies,Binders,77,77,77
AZ-2014-756508,79,24,9,Office Supplies,Labels,55,55,216
AZ-2014-7575178,299,0,6,Office Supplies,Art,299,299,0
AZ-2014-7578563,918,22,9,Technology,Machines,896,896,198
AZ-2014-758467,749,307,7,Furniture,Furnishings,442,442,2149
AZ-2014-758467,71,4,5,Office Supplies,Fasteners,67,67,20
AZ-2014-758467,487,-23,3,Technology,Copiers,510,510,-69
AZ-2014-7597862,44,11,4,Office Supplies,Art,33,33,44
AZ-2014-7604524,32,8,5,Office Supplies,Binders,24,24,40
AZ-2014-7608548,108,26,4,Office Supplies,Supplies,82,82,104
AZ-2014-7610238,197,20,4,Office Supplies,Envelopes,177,177,80
AZ-2014-7613436,304,97,6,Office Supplies,Art,207,207,582
AZ-2014-7614787,561,118,5,Furniture,Bookcases,443,443,590
AZ-2014-7615629,32,-12,1,Furniture,Chairs,44,44,-12
AZ-2014-7615629,161,-229,8,Furniture,Furnishings,390,390,-1832
AZ-2014-7615629,50,-4,6,Office Supplies,Paper,54,54,-24
AZ-2014-7615931,48,2,3,Office Supplies,Art,46,46,6
AZ-2014-7615931,13,3,1,Office Supplies,Fasteners,10,10,3
AZ-2014-7615931,230,5,2,Office Supplies,Storage,225,225,10
AZ-2014-766953,245,91,2,Furniture,Bookcases,154,154,182
AZ-2014-766953,867,251,5,Technology,Phones,616,616,1255
AZ-2014-7674132,62,8,2,Office Supplies,Paper,54,54,16
AZ-2014-767884,284,45,2,Furniture,Bookcases,239,239,90
AZ-2014-767884,12,1,2,Office Supplies,Binders,11,11,2
AZ-2014-767884,104,38,6,Office Supplies,Envelopes,55,66,228
AZ-2014-767884,42,13,3,Office Supplies,Fasteners,29,29,39
AZ-2014-767884,54,12,3,Office Supplies,Storage,42,42,36
AZ-2014-7679425,341,160,7,Office Supplies,Art,181,181,1120
AZ-2014-7679425,560,44,3,Office Supplies,Storage,516,516,132
AZ-2014-7679425,57,27,2,Office Supplies,Supplies,30,30,54
AZ-2014-7702774,101,30,4,Office Supplies,Art,26,71,120
AZ-2014-7702774,180,54,4,Office Supplies,Paper,126,126,216
AZ-2014-7702774,1063,-175,4,Technology,Machines,1238,1238,-700
AZ-2014-77046,193,8,4,Office Supplies,Paper,185,185,32
AZ-2014-7709968,662,240,2,Furniture,Bookcases,422,422,480
AZ-2014-7709968,29,2,3,Office Supplies,Labels,27,27,6
AZ-2014-772338,39,14,5,Office Supplies,Fasteners,25,25,70
AZ-2014-772338,4141,1698,13,Technology,Copiers,2443,2443,22074
AZ-2014-7725232,571,108,12,Office Supplies,Art,463,463,1296
AZ-2014-7725232,398,111,8,Office Supplies,Binders,287,287,888
AZ-2014-7725232,79,39,2,Office Supplies,Supplies,40,40,78
AZ-2014-772814,115,47,2,Technology,Accessories,68,68,94
AZ-2014-777252,244,83,2,Furniture,Bookcases,161,161,166
AZ-2014-7782987,742,198,2,Furniture,Bookcases,544,544,396
AZ-2014-7782987,111,9,4,Office Supplies,Art,102,102,36
AZ-2014-7782987,365,107,3,Technology,Phones,258,258,321
AZ-2014-778430,203,84,2,Technology,Copiers,119,119,168
AZ-2014-7786801,2452,191,7,Furniture,Bookcases,2261,2261,1337
AZ-2014-7786801,171,17,6,Office Supplies,Paper,154,154,102
AZ-2014-7795641,119,-24,4,Furniture,Furnishings,143,143,-96
AZ-2014-7795641,229,59,9,Office Supplies,Storage,170,170,531
AZ-2014-7795641,811,154,7,Technology,Accessories,657,657,1078
AZ-2014-7795641,720,43,2,Technology,Copiers,677,677,86
AZ-2014-7801536,17,2,2,Office Supplies,Labels,15,15,4
AZ-2014-7828489,510,234,6,Technology,Machines,276,276,1404
AZ-2014-783246,346,108,3,Furniture,Chairs,238,238,324
AZ-2014-783246,17,7,3,Office Supplies,Binders,10,10,21
AZ-2014-7862965,1270,546,11,Technology,Machines,724,724,6006
AZ-2014-786652,199,0,4,Office Supplies,Art,199,199,0
AZ-2014-786652,89,6,5,Office Supplies,Storage,83,83,30
AZ-2014-7873209,53,8,3,Furniture,Furnishings,45,45,24
AZ-2014-7893156,544,-152,3,Furniture,Bookcases,696,696,-456
AZ-2014-7895228,34,10,3,Office Supplies,Labels,24,24,30
AZ-2014-7895228,260,68,2,Technology,Copiers,192,192,136
AZ-2014-7895228,312,62,1,Technology,Machines,250,250,62
AZ-2014-789686,48,16,3,Office Supplies,Supplies,32,32,48
AZ-2014-7906967,366,84,3,Furniture,Bookcases,282,282,252
AZ-2014-7906967,26,3,3,Office Supplies,Labels,23,23,9
AZ-2014-7906967,446,53,3,Technology,Copiers,393,393,159
AZ-2014-791703,171,-140,2,Furniture,Bookcases,311,311,-280
AZ-2014-791703,34,-12,5,Office Supplies,Fasteners,46,46,-60
AZ-2014-7917041,429,17,3,Furniture,Chairs,412,412,51
AZ-2014-7917041,105,32,8,Office Supplies,Binders,58,73,256
AZ-2014-7929704,637,212,8,Technology,Phones,425,425,1696
AZ-2014-7938623,681,259,4,Furniture,Chairs,422,422,1036
AZ-2014-7938623,32,2,2,Office Supplies,Envelopes,30,30,4
AZ-2014-7938623,132,49,3,Office Supplies,Supplies,83,83,147
AZ-2014-795523,1157,-13,9,Furniture,Bookcases,1170,1170,-117
AZ-2014-795523,105,25,2,Office Supplies,Binders,80,80,50
AZ-2014-795523,360,32,3,Office Supplies,Storage,328,328,96
AZ-2014-795523,252,56,2,Technology,Phones,196,196,112
AZ-2014-7955306,147,73,3,Office Supplies,Art,74,74,219
AZ-2014-7955306,16,2,1,Office Supplies,Storage,14,14,2
AZ-2014-7956998,92,20,5,Office Supplies,Binders,49,72,100
AZ-2014-7956998,614,84,6,Technology,Phones,418,530,504
AZ-2014-797220,89,-37,4,Office Supplies,Supplies,126,126,-148
AZ-2014-7973944,2927,146,8,Furniture,Bookcases,2781,2781,1168
AZ-2014-7973944,294,62,9,Office Supplies,Paper,232,232,558
AZ-2014-7973944,200,13,5,Technology,Phones,187,187,65
AZ-2014-7978715,954,95,3,Technology,Copiers,859,859,285
AZ-2014-7988186,110,20,5,Office Supplies,Art,90,90,100
AZ-2014-7988186,54,14,3,Office Supplies,Paper,40,40,42
AZ-2014-8007090,39,2,2,Office Supplies,Storage,37,37,4
AZ-2014-8008458,45,8,4,Office Supplies,Labels,37,37,32
AZ-2014-8014717,1716,309,7,Technology,Accessories,1407,1407,2163
AZ-2014-8026360,189,60,4,Furniture,Furnishings,129,129,240
AZ-2014-8026360,672,-16,3,Technology,Machines,549,688,-48
AZ-2014-8034683,44,10,3,Office Supplies,Art,34,34,30
AZ-2014-8034683,27,0,2,Office Supplies,Fasteners,27,27,0
AZ-2014-8034683,48,11,2,Office Supplies,Supplies,37,37,22
AZ-2014-8054390,1218,352,9,Furniture,Bookcases,866,866,3168
AZ-2014-8054390,87,36,5,Office Supplies,Art,51,51,180
AZ-2014-8054390,891,0,5,Office Supplies,Storage,891,891,0
AZ-2014-8054390,146,66,1,Technology,Phones,80,80,66
AZ-2014-8055993,67,20,4,Office Supplies,Paper,47,47,80
AZ-2014-8055993,744,119,6,Technology,Copiers,625,625,714
AZ-2014-8059227,81,41,3,Office Supplies,Art,40,40,123
AZ-2014-8059227,44,2,3,Office Supplies,Binders,42,42,6
AZ-2014-8059227,116,22,1,Technology,Accessories,94,94,22
AZ-2014-8061862,22,-8,4,Office Supplies,Binders,30,30,-32
AZ-2014-8061862,188,-193,2,Technology,Machines,381,381,-386
AZ-2014-8072952,44,14,3,Office Supplies,Binders,30,30,42
AZ-2014-8090092,352,18,5,Office Supplies,Appliances,334,334,90
AZ-2014-8090092,147,48,3,Office Supplies,Storage,99,99,144
AZ-2014-8090546,173,69,3,Furniture,Chairs,104,104,207
AZ-2014-8101198,742,198,2,Furniture,Bookcases,544,544,396
AZ-2014-8101198,14,0,4,Office Supplies,Binders,14,14,0
AZ-2014-8101198,87,32,9,Office Supplies,Labels,55,55,288
AZ-2014-8101198,935,114,4,Technology,Machines,821,821,456
AZ-2014-8122105,250,100,3,Office Supplies,Appliances,150,150,300
AZ-2014-8122105,89,29,2,Office Supplies,Art,60,60,58
AZ-2014-8122105,30,5,2,Office Supplies,Envelopes,25,25,10
AZ-2014-8122105,248,105,2,Technology,Phones,143,143,210
AZ-2014-8128242,120,23,5,Office Supplies,Art,97,97,115
AZ-2014-8128242,40,18,1,Technology,Accessories,22,22,18
AZ-2014-81293,111,11,9,Office Supplies,Binders,100,100,99
AZ-2014-8131624,102,13,2,Office Supplies,Art,89,89,26
AZ-2014-8131624,50,14,1,Technology,Machines,36,36,14
AZ-2014-8132045,133,5,5,Office Supplies,Art,128,128,25
AZ-2014-8154802,190,19,9,Furniture,Furnishings,171,171,171
AZ-2014-8154802,158,-29,10,Office Supplies,Binders,187,187,-290
AZ-2014-8154802,136,-33,5,Office Supplies,Storage,169,169,-165
AZ-2014-8168742,1622,95,5,Technology,Copiers,1527,1527,475
AZ-2014-8174835,261,13,6,Office Supplies,Supplies,248,248,78
AZ-2014-8184590,54,27,2,Office Supplies,Art,27,27,54
AZ-2014-8184590,644,167,2,Technology,Copiers,477,477,334
AZ-2014-818907,13,4,1,Office Supplies,Fasteners,9,9,4
AZ-2014-8193054,151,9,3,Office Supplies,Binders,142,142,27
AZ-2014-8202914,140,57,2,Office Supplies,Appliances,83,83,114
AZ-2014-8203998,152,23,3,Furniture,Furnishings,129,129,69
AZ-2014-8203998,24,11,3,Office Supplies,Binders,13,13,33
AZ-2014-8231196,290,35,6,Office Supplies,Binders,255,255,210
AZ-2014-8231196,207,33,2,Technology,Accessories,174,174,66
AZ-2014-8232144,146,7,2,Technology,Phones,139,139,14
AZ-2014-8257707,63,14,2,Office Supplies,Supplies,49,49,28
AZ-2014-8257707,765,-36,3,Technology,Machines,801,801,-108
AZ-2014-8284131,245,10,2,Furniture,Bookcases,235,235,20
AZ-2014-8284131,60,3,3,Office Supplies,Storage,57,57,9
AZ-2014-8286084,137,38,5,Office Supplies,Binders,99,99,190
AZ-2014-8286084,169,38,3,Office Supplies,Storage,131,131,114
AZ-2014-8294649,1547,340,6,Technology,Accessories,1207,1207,2040
AZ-2014-8297343,48,20,4,Office Supplies,Art,28,28,80
AZ-2014-8297343,26,7,4,Office Supplies,Binders,19,19,28
AZ-2014-8297343,149,15,3,Office Supplies,Storage,134,134,45
AZ-2014-8308689,55,4,2,Office Supplies,Art,51,51,8
AZ-2014-8308689,13,3,2,Office Supplies,Binders,10,10,6
AZ-2014-8308689,46,0,4,Office Supplies,Fasteners,46,46,0
AZ-2014-8308689,177,41,4,Office Supplies,Supplies,136,136,164
AZ-2014-8308689,646,-23,2,Technology,Copiers,669,669,-46
AZ-2014-8335609,61,1,2,Furniture,Furnishings,60,60,2
AZ-2014-8335609,59,25,3,Office Supplies,Art,34,34,75
AZ-2014-8335609,197,59,5,Technology,Accessories,43,138,295
AZ-2014-8335609,469,33,4,Technology,Machines,436,436,132
AZ-2014-839784,1101,352,3,Furniture,Bookcases,749,749,1056
AZ-2014-8427942,1657,460,4,Furniture,Chairs,1197,1197,1840
AZ-2014-8427942,61,25,4,Office Supplies,Storage,36,36,100
AZ-2014-8432869,162,20,3,Furniture,Chairs,142,142,60
AZ-2014-8432869,150,32,3,Office Supplies,Binders,118,118,96
AZ-2014-8438801,105,33,6,Office Supplies,Storage,72,72,198
AZ-2014-8438862,73,-36,3,Furniture,Chairs,109,109,-108
AZ-2014-8438862,71,-14,4,Furniture,Furnishings,85,85,-56
AZ-2014-8438862,81,-44,3,Office Supplies,Art,125,125,-132
AZ-2014-8438862,619,-512,8,Office Supplies,Storage,824,1131,-4096
AZ-2014-8465996,202,89,9,Office Supplies,Paper,113,113,801
AZ-2014-8467172,595,119,4,Furniture,Bookcases,476,476,476
AZ-2014-8467172,209,46,7,Office Supplies,Binders,122,163,322
AZ-2014-8469117,1308,536,3,Furniture,Bookcases,772,772,1608
AZ-2014-8469117,370,-220,6,Furniture,Chairs,351,590,-1320
AZ-2014-8469117,40,13,3,Office Supplies,Paper,27,27,39
AZ-2014-8469117,351,-94,5,Technology,Machines,445,445,-470
AZ-2014-8480616,25,10,1,Furniture,Furnishings,15,15,10
AZ-2014-8480616,122,15,3,Technology,Accessories,107,107,45
AZ-2014-8487214,57,6,5,Office Supplies,Fasteners,51,51,30
AZ-2014-8487214,200,7,4,Technology,Machines,193,193,28
AZ-2014-8488653,1228,14,3,Furniture,Chairs,1214,1214,42
AZ-2014-8489084,27,12,1,Office Supplies,Art,15,15,12
AZ-2014-8489084,314,-41,3,Technology,Machines,355,355,-123
AZ-2014-8489186,148,54,2,Furniture,Chairs,94,94,108
AZ-2014-8492621,253,-11,1,Office Supplies,Appliances,264,264,-11
AZ-2014-8492621,3873,891,6,Technology,Phones,2982,2982,5346
AZ-2014-8495612,484,28,3,Technology,Copiers,456,456,84
AZ-2014-8498328,226,58,3,Technology,Accessories,168,168,174
AZ-2014-8512143,52,18,2,Office Supplies,Art,34,34,36
AZ-2014-8531575,155,-86,7,Technology,Accessories,126,241,-602
AZ-2014-8532434,170,19,5,Office Supplies,Paper,151,151,95
AZ-2014-8533393,100,7,2,Office Supplies,Paper,93,93,14
AZ-2014-8536659,977,244,7,Technology,Phones,733,733,1708
AZ-2014-8546369,1599,37,6,Technology,Machines,1562,1562,222
AZ-2014-8548131,110,12,7,Office Supplies,Art,98,98,84
AZ-2014-8548131,636,204,2,Technology,Copiers,432,432,408
AZ-2014-8555156,244,122,5,Furniture,Furnishings,122,122,610
AZ-2014-8555156,28,4,1,Office Supplies,Paper,24,24,4
AZ-2014-855671,80,26,9,Office Supplies,Labels,54,54,234
AZ-2014-855671,100,12,2,Office Supplies,Paper,88,88,24
AZ-2014-856008,460,143,3,Furniture,Chairs,317,317,429
AZ-2014-856008,125,22,3,Office Supplies,Art,103,103,66
AZ-2014-856008,277,3,1,Technology,Machines,274,274,3
AZ-2014-8562932,103,21,7,Office Supplies,Art,82,82,147
AZ-2014-8568021,102,11,6,Office Supplies,Paper,91,91,66
AZ-2014-8568161,40,15,1,Office Supplies,Envelopes,25,25,15
AZ-2014-8568817,1622,-624,5,Furniture,Tables,2246,2246,-3120
AZ-2014-8568817,259,47,5,Office Supplies,Binders,212,212,235
AZ-2014-8568817,33,1,2,Office Supplies,Supplies,32,32,2
AZ-2014-8582071,685,7,7,Office Supplies,Appliances,678,678,49
AZ-2014-8582071,850,289,5,Technology,Machines,561,561,1445
AZ-2014-8589669,125,15,5,Office Supplies,Supplies,110,110,75
AZ-2014-8610318,12,2,2,Office Supplies,Labels,10,10,4
AZ-2014-8611062,1945,370,8,Technology,Phones,1374,1575,2960
AZ-2014-8612658,230,77,9,Office Supplies,Art,102,153,693
AZ-2014-8612658,30,11,5,Office Supplies,Binders,19,19,55
AZ-2014-8612658,179,25,5,Office Supplies,Envelopes,154,154,125
AZ-2014-8612658,168,56,3,Office Supplies,Storage,112,112,168
AZ-2014-8612658,108,22,3,Technology,Accessories,86,86,66
AZ-2014-861955,83,12,2,Furniture,Chairs,71,71,24
AZ-2014-8630899,871,131,2,Furniture,Bookcases,740,740,262
AZ-2014-8636627,60,-10,2,Furniture,Furnishings,70,70,-20
AZ-2014-8636627,204,94,4,Office Supplies,Binders,110,110,376
AZ-2014-8636627,74,33,2,Office Supplies,Supplies,41,41,66
AZ-2014-8636627,336,57,2,Technology,Phones,279,279,114
AZ-2014-8636946,37,17,3,Office Supplies,Binders,20,20,51
AZ-2014-8637835,19,8,2,Office Supplies,Binders,11,11,16
AZ-2014-8637835,25,11,3,Office Supplies,Fasteners,14,14,33
AZ-2014-8638233,1700,85,3,Office Supplies,Appliances,1615,1615,255
AZ-2014-8638233,609,103,12,Technology,Accessories,128,506,1236
AZ-2014-8639155,802,120,7,Technology,Accessories,682,682,840
AZ-2014-8648912,268,6,2,Furniture,Bookcases,262,262,12
AZ-2014-8652861,159,2,3,Furniture,Furnishings,157,157,6
AZ-2014-8652861,61,28,2,Office Supplies,Binders,33,33,56
AZ-2014-8652861,79,6,7,Office Supplies,Storage,73,73,42
AZ-2014-8665160,158,38,3,Office Supplies,Binders,120,120,114
AZ-2014-8665160,90,27,2,Office Supplies,Paper,63,63,54
AZ-2014-8671792,846,9,2,Furniture,Chairs,837,837,18
AZ-2014-8671792,15,2,1,Office Supplies,Fasteners,13,13,2
AZ-2014-8671792,140,68,5,Office Supplies,Paper,72,72,340
AZ-2014-8671792,210,62,2,Technology,Phones,148,148,124
AZ-2014-8676068,43,17,1,Office Supplies,Storage,26,26,17
AZ-2014-8677519,28,6,4,Office Supplies,Labels,22,22,24
AZ-2014-8677910,857,274,2,Furniture,Tables,583,583,548
AZ-2014-8677910,22,9,2,Office Supplies,Fasteners,13,13,18
AZ-2014-8682388,915,-99,3,Furniture,Tables,1014,1014,-297
AZ-2014-8682388,191,93,4,Office Supplies,Supplies,98,98,372
AZ-2014-8687924,147,73,3,Office Supplies,Art,74,74,219
AZ-2014-8687924,53,5,3,Office Supplies,Paper,48,48,15
AZ-2014-8687924,171,2,2,Technology,Machines,169,169,4
AZ-2014-8696751,33,13,3,Office Supplies,Fasteners,20,20,39
AZ-2014-8696751,499,33,4,Office Supplies,Storage,466,466,132
AZ-2014-870440,79,-2,2,Furniture,Furnishings,81,81,-4
AZ-2014-870440,43,5,3,Office Supplies,Art,38,38,15
AZ-2014-870440,57,21,8,Office Supplies,Binders,23,36,168
AZ-2014-870440,734,213,6,Technology,Machines,521,521,1278
AZ-2014-8708841,103,36,2,Office Supplies,Binders,67,67,72
AZ-2014-8708841,287,66,6,Office Supplies,Envelopes,221,221,396
AZ-2014-8708841,23,4,2,Office Supplies,Labels,19,19,8
AZ-2014-8735182,190,68,8,Office Supplies,Paper,122,122,544
AZ-2014-8737214,42,7,2,Office Supplies,Envelopes,35,35,14
AZ-2014-874376,388,93,2,Furniture,Bookcases,295,295,186
AZ-2014-874376,31,11,3,Office Supplies,Labels,20,20,33
AZ-2014-8751101,1246,62,3,Furniture,Bookcases,1184,1184,186
AZ-2014-8770825,83,12,3,Office Supplies,Art,71,71,36
AZ-2014-8773911,223,62,7,Office Supplies,Supplies,161,161,434
AZ-2014-8781156,372,59,3,Technology,Copiers,313,313,177
AZ-2014-8796314,355,114,7,Office Supplies,Art,241,241,798
AZ-2014-8796314,61,11,3,Office Supplies,Envelopes,50,50,33
AZ-2014-8796314,149,15,3,Office Supplies,Storage,134,134,45
AZ-2014-8796314,688,103,6,Technology,Accessories,585,585,618
AZ-2014-8803055,121,41,4,Office Supplies,Art,80,80,164
AZ-2014-8803055,139,30,3,Office Supplies,Supplies,109,109,90
AZ-2014-8808446,122,38,9,Office Supplies,Binders,23,84,342
AZ-2014-8812108,119,43,7,Office Supplies,Envelopes,76,76,301
AZ-2014-8812108,114,11,4,Office Supplies,Paper,103,103,44
AZ-2014-8812108,465,207,9,Office Supplies,Storage,258,258,1863
AZ-2014-8841844,31,10,1,Office Supplies,Envelopes,21,21,10
AZ-2014-8848786,646,213,3,Technology,Machines,433,433,639
AZ-2014-8849270,18,2,3,Office Supplies,Binders,16,16,6
AZ-2014-8849270,223,4,3,Technology,Phones,219,219,12
AZ-2014-8854182,2125,234,6,Technology,Copiers,1891,1891,1404
AZ-2014-8864215,83,6,6,Office Supplies,Supplies,77,77,36
AZ-2014-886827,107,37,3,Office Supplies,Supplies,70,70,111
AZ-2014-8880439,63,1,4,Office Supplies,Paper,62,62,4
AZ-2014-8890800,394,146,2,Furniture,Bookcases,248,248,292
AZ-2014-8890800,734,248,2,Furniture,Chairs,486,486,496
AZ-2014-8890800,438,17,9,Office Supplies,Art,349,421,153
AZ-2014-8890800,502,84,4,Technology,Phones,418,418,336
AZ-2014-8899195,94,27,2,Office Supplies,Supplies,67,67,54
AZ-2014-8899652,24,2,4,Office Supplies,Binders,22,22,8
AZ-2014-8900102,127,29,3,Furniture,Furnishings,98,98,87
AZ-2014-8900102,16,-15,4,Office Supplies,Binders,31,31,-60
AZ-2014-8900102,10,-2,2,Office Supplies,Fasteners,12,12,-4
AZ-2014-8902331,105,26,8,Office Supplies,Fasteners,79,79,208
AZ-2014-8912005,2115,23,5,Furniture,Chairs,2092,2092,115
AZ-2014-8912005,121,19,4,Office Supplies,Art,102,102,76
AZ-2014-8912005,146,42,5,Office Supplies,Binders,104,104,210
AZ-2014-8916168,36,7,3,Office Supplies,Fasteners,29,29,21
AZ-2014-8935301,2244,247,4,Office Supplies,Appliances,1997,1997,988
AZ-2014-8937167,1351,111,6,Technology,Machines,1240,1240,666
AZ-2014-8951189,26,9,2,Office Supplies,Fasteners,17,17,18
AZ-2014-8955026,108,37,2,Office Supplies,Art,71,71,74
AZ-2014-8955026,37,3,3,Office Supplies,Binders,34,34,9
AZ-2014-8957312,719,303,6,Furniture,Chairs,416,416,1818
AZ-2014-8957312,57,28,2,Office Supplies,Envelopes,29,29,56
AZ-2014-8967305,741,267,5,Furniture,Bookcases,474,474,1335
AZ-2014-8970426,140,15,5,Office Supplies,Art,125,125,75
AZ-2014-8973958,84,41,3,Office Supplies,Paper,43,43,123
AZ-2014-8976002,165,46,3,Furniture,Furnishings,119,119,138
AZ-2014-8976002,46,0,4,Office Supplies,Fasteners,46,46,0
AZ-2014-8986990,269,33,5,Furniture,Chairs,236,236,165
AZ-2014-8986990,24,8,2,Office Supplies,Labels,16,16,16
AZ-2014-8991506,1419,582,6,Office Supplies,Appliances,268,837,3492
AZ-2014-8993401,42,12,2,Office Supplies,Envelopes,30,30,24
AZ-2014-8993401,124,54,5,Office Supplies,Paper,70,70,270
AZ-2014-8993401,248,8,2,Office Supplies,Storage,240,240,16
AZ-2014-9007405,1275,357,2,Technology,Phones,918,918,714
AZ-2014-9018441,7,1,1,Office Supplies,Binders,6,6,1
AZ-2014-9021616,66,12,3,Office Supplies,Art,54,54,36
AZ-2014-9021616,367,73,3,Technology,Machines,294,294,219
AZ-2014-9026521,57,7,3,Furniture,Furnishings,50,50,21
AZ-2014-9026521,591,138,13,Office Supplies,Binders,360,453,1794
AZ-2014-9026521,57,27,2,Office Supplies,Supplies,30,30,54
AZ-2014-9044600,845,84,7,Office Supplies,Storage,761,761,588
AZ-2014-9050550,10,4,1,Office Supplies,Envelopes,6,6,4
AZ-2014-9065291,86,9,3,Office Supplies,Storage,77,77,27
AZ-2014-9066153,1118,206,2,Furniture,Tables,912,912,412
AZ-2014-9082134,170,73,2,Technology,Accessories,97,97,146
AZ-2014-9082134,62,-1,1,Technology,Phones,63,63,-1
AZ-2014-9092874,82,28,5,Office Supplies,Art,37,54,140
AZ-2014-9092874,240,12,6,Office Supplies,Envelopes,228,228,72
AZ-2014-9092874,163,26,4,Office Supplies,Supplies,137,137,104
AZ-2014-9102115,27,9,2,Office Supplies,Binders,18,18,18
AZ-2014-9102115,85,-1,3,Office Supplies,Storage,86,86,-3
AZ-2014-9106967,2061,701,5,Furniture,Bookcases,1360,1360,3505
AZ-2014-9106967,490,137,18,Office Supplies,Art,80,353,2466
AZ-2014-9106967,17,5,1,Office Supplies,Binders,12,12,5
AZ-2014-9106967,22,8,2,Office Supplies,Fasteners,14,14,16
AZ-2014-9111247,56,18,2,Office Supplies,Binders,38,38,36
AZ-2014-9111247,216,-83,3,Technology,Machines,299,299,-249
AZ-2014-9111832,44,14,3,Office Supplies,Binders,30,30,42
AZ-2014-9133960,62,6,5,Office Supplies,Binders,56,56,30
AZ-2014-9135903,50,3,2,Office Supplies,Art,47,47,6
AZ-2014-9141986,128,4,3,Office Supplies,Storage,124,124,12
AZ-2014-9165152,724,253,2,Furniture,Bookcases,471,471,506
AZ-2014-9165152,112,24,3,Office Supplies,Envelopes,88,88,72
AZ-2014-9173852,223,27,2,Furniture,Bookcases,196,196,54
AZ-2014-9173852,2457,665,11,Technology,Machines,1792,1792,7315
AZ-2014-9189061,245,30,2,Office Supplies,Storage,215,215,60
AZ-2014-9211150,16,0,1,Office Supplies,Storage,16,16,0
AZ-2014-9225058,82,13,2,Office Supplies,Supplies,69,69,26
AZ-2014-9225058,294,109,7,Technology,Accessories,185,185,763
AZ-2014-9229911,598,166,4,Furniture,Bookcases,432,432,664
AZ-2014-9229911,227,59,2,Furniture,Furnishings,168,168,118
AZ-2014-9229911,22,8,3,Office Supplies,Binders,14,14,24
AZ-2014-9229911,56,16,6,Office Supplies,Labels,18,40,96
AZ-2014-9252618,197,73,1,Furniture,Bookcases,124,124,73
AZ-2014-9252618,550,242,5,Furniture,Furnishings,308,308,1210
AZ-2014-9252618,74,29,3,Office Supplies,Art,45,45,87
AZ-2014-9252618,10,2,2,Office Supplies,Labels,8,8,4
AZ-2014-9252618,994,99,8,Office Supplies,Storage,599,895,792
AZ-2014-9252618,324,39,8,Technology,Accessories,285,285,312
AZ-2014-9257351,159,42,4,Office Supplies,Binders,86,117,168
AZ-2014-9257351,1027,441,8,Office Supplies,Storage,586,586,3528
AZ-2014-9257351,1319,567,5,Technology,Copiers,752,752,2835
AZ-2014-9283852,90,17,3,Office Supplies,Binders,73,73,51
AZ-2014-9284245,434,142,5,Office Supplies,Storage,55,292,710
AZ-2014-9284245,829,19,4,Technology,Copiers,810,810,76
AZ-2014-9284245,442,31,2,Technology,Machines,411,411,62
AZ-2014-9290079,40,16,3,Office Supplies,Binders,24,24,48
AZ-2014-9292431,342,154,7,Furniture,Furnishings,188,188,1078
AZ-2014-9361129,88,16,4,Office Supplies,Art,72,72,64
AZ-2014-938052,76,19,3,Office Supplies,Binders,57,57,57
AZ-2014-9380952,348,96,10,Office Supplies,Art,151,252,960
AZ-2014-9380952,436,131,9,Office Supplies,Binders,305,305,1179
AZ-2014-9397794,95,11,4,Furniture,Furnishings,84,84,44
AZ-2014-9397794,128,4,3,Office Supplies,Storage,124,124,12
AZ-2014-9418749,2093,721,5,Furniture,Chairs,1372,1372,3605
AZ-2014-9423386,26,11,2,Office Supplies,Binders,15,15,22
AZ-2014-9423386,19,6,2,Office Supplies,Storage,13,13,12
AZ-2014-9423386,579,139,3,Technology,Copiers,440,440,417
AZ-2014-942941,30,14,3,Office Supplies,Binders,16,16,42
AZ-2014-9433956,39,16,6,Office Supplies,Labels,23,23,96
AZ-2014-9440624,105,33,5,Office Supplies,Envelopes,72,72,165
AZ-2014-944918,869,67,4,Furniture,Tables,802,802,268
AZ-2014-9462955,147,33,3,Office Supplies,Art,80,114,99
AZ-2014-9468178,69,13,6,Office Supplies,Binders,23,56,78
AZ-2014-9479469,320,144,1,Technology,Copiers,176,176,144
AZ-2014-9491986,135,54,5,Office Supplies,Envelopes,81,81,270
AZ-2014-9491986,237,47,9,Office Supplies,Paper,190,190,423
AZ-2014-9494759,90,29,5,Office Supplies,Paper,61,61,145
AZ-2014-9494759,62,1,3,Office Supplies,Storage,61,61,3
AZ-2014-9502741,336,71,3,Furniture,Bookcases,265,265,213
AZ-2014-9502741,53,24,6,Office Supplies,Binders,29,29,144
AZ-2014-9504290,57,27,2,Office Supplies,Paper,30,30,54
AZ-2014-9504290,103,46,2,Office Supplies,Storage,57,57,92
AZ-2014-9518862,300,42,2,Technology,Copiers,258,258,84
AZ-2014-9538326,10,2,2,Office Supplies,Binders,8,8,4
AZ-2014-9539724,485,199,4,Office Supplies,Storage,286,286,796
AZ-2014-9550736,117,36,2,Office Supplies,Appliances,81,81,72
AZ-2014-9550736,916,192,11,Technology,Phones,724,724,2112
AZ-2014-955637,148,24,3,Office Supplies,Art,124,124,72
AZ-2014-955637,24,1,4,Office Supplies,Binders,23,23,4
AZ-2014-955637,513,215,2,Technology,Accessories,298,298,430
AZ-2014-9560415,93,-1,2,Office Supplies,Binders,94,94,-2
AZ-2014-9560415,52,18,5,Office Supplies,Fasteners,34,34,90
AZ-2014-9561392,45,1,3,Office Supplies,Paper,44,44,3
AZ-2014-9575428,411,92,13,Furniture,Furnishings,193,319,1196
AZ-2014-9575428,16,8,2,Office Supplies,Binders,8,8,16
AZ-2014-9575428,648,50,6,Technology,Machines,598,598,300
AZ-2014-9575428,336,123,3,Technology,Phones,213,213,369
AZ-2014-9580273,132,54,5,Office Supplies,Art,78,78,270
AZ-2014-9580273,94,7,7,Office Supplies,Fasteners,87,87,49
AZ-2014-9580273,643,225,2,Technology,Copiers,418,418,450
AZ-2014-9583503,757,371,2,Technology,Copiers,386,386,742
AZ-2014-9586532,82,33,4,Office Supplies,Envelopes,49,49,132
AZ-2014-9590613,45,0,2,Office Supplies,Art,45,45,0
AZ-2014-9590613,86,8,2,Office Supplies,Storage,78,78,16
AZ-2014-9590613,274,-7,4,Technology,Phones,281,281,-28
AZ-2014-9593137,18,6,3,Office Supplies,Binders,12,12,18
AZ-2014-9603730,255,74,5,Office Supplies,Binders,181,181,370
AZ-2014-9629800,50,7,6,Office Supplies,Labels,43,43,42
AZ-2014-9629800,214,30,3,Technology,Accessories,184,184,90
AZ-2014-9634517,22,11,2,Office Supplies,Labels,11,11,22
AZ-2014-9634517,1543,370,8,Technology,Copiers,1173,1173,2960
AZ-2014-963453,544,135,4,Furniture,Bookcases,185,409,540
AZ-2014-963453,262,64,6,Office Supplies,Storage,198,198,384
AZ-2014-9650132,161,40,3,Office Supplies,Art,121,121,120
AZ-2014-9650132,1250,486,7,Office Supplies,Storage,764,764,3402
AZ-2014-9653961,263,50,5,Office Supplies,Art,213,213,250
AZ-2014-9653961,151,45,12,Office Supplies,Binders,44,106,540
AZ-2014-9653961,955,305,3,Technology,Copiers,650,650,915
AZ-2014-9673217,1298,65,9,Technology,Copiers,1233,1233,585
AZ-2014-9676120,155,26,3,Office Supplies,Art,129,129,78
AZ-2014-96826,16,5,1,Office Supplies,Art,11,11,5
AZ-2014-96826,79,13,7,Office Supplies,Fasteners,41,66,91
AZ-2014-9683756,45,16,3,Office Supplies,Art,29,29,48
AZ-2014-9683881,36,4,9,Office Supplies,Binders,32,32,36
AZ-2014-9687341,64,27,5,Office Supplies,Binders,37,37,135
AZ-2014-9712649,504,116,3,Furniture,Bookcases,388,388,348
AZ-2014-9727546,693,254,6,Office Supplies,Storage,439,439,1524
AZ-2014-9733542,71,0,8,Office Supplies,Labels,71,71,0
AZ-2014-9733542,93,15,2,Technology,Accessories,78,78,30
AZ-2014-9733542,3017,846,10,Technology,Phones,999,2171,8460
AZ-2014-9736684,386,49,13,Office Supplies,Binders,307,337,637
AZ-2014-9736684,54,1,2,Office Supplies,Storage,53,53,2
AZ-2014-9742933,350,32,8,Office Supplies,Storage,131,318,256
AZ-2014-9743631,15,2,1,Office Supplies,Fasteners,13,13,2
AZ-2014-9749362,156,21,3,Furniture,Chairs,135,135,63
AZ-2014-9749362,537,107,3,Office Supplies,Storage,430,430,321
AZ-2014-9760278,115,25,6,Office Supplies,Art,90,90,150
AZ-2014-9760278,140,6,5,Office Supplies,Storage,134,134,30
AZ-2014-9760278,637,261,2,Technology,Copiers,376,376,522
AZ-2014-9761172,204,88,4,Furniture,Furnishings,53,116,352
AZ-2014-9761172,911,355,5,Technology,Phones,556,556,1775
AZ-2014-9774095,59,6,1,Technology,Accessories,53,53,6
AZ-2014-9783115,104,2,2,Furniture,Furnishings,102,102,4
AZ-2014-978460,2103,322,8,Technology,Machines,1781,1781,2576
AZ-2014-9792783,34,13,2,Office Supplies,Storage,21,21,26
AZ-2014-9794319,60,21,4,Office Supplies,Art,39,39,84
AZ-2014-9794319,17,0,1,Office Supplies,Binders,17,17,0
AZ-2014-9794319,125,0,3,Technology,Accessories,125,125,0
AZ-2014-9797465,119,1,1,Furniture,Chairs,118,118,1
AZ-2014-980530,94,20,2,Furniture,Furnishings,74,74,40
AZ-2014-980530,28,14,4,Office Supplies,Binders,14,14,56
AZ-2014-980530,417,49,3,Technology,Machines,368,368,147
AZ-2014-9815081,32,11,2,Office Supplies,Fasteners,21,21,22
AZ-2014-9821147,36,0,4,Office Supplies,Envelopes,36,36,0
AZ-2014-9838410,75,28,9,Office Supplies,Binders,47,47,252
AZ-2014-985095,426,127,10,Office Supplies,Art,21,299,1270
AZ-2014-985095,743,89,5,Technology,Copiers,654,654,445
AZ-2014-986540,118,35,7,Office Supplies,Paper,83,83,245
AZ-2014-986540,462,169,4,Office Supplies,Storage,293,293,676
AZ-2014-9866663,911,202,7,Furniture,Chairs,709,709,1414
AZ-2014-9876300,385,99,9,Office Supplies,Binders,74,286,891
AZ-2014-9876425,92,42,2,Office Supplies,Art,50,50,84
AZ-2014-9876425,29,8,5,Office Supplies,Binders,21,21,40
AZ-2014-9876866,59,21,2,Office Supplies,Art,38,38,42
AZ-2014-9876866,443,138,12,Office Supplies,Binders,160,305,1656
AZ-2014-9876866,1120,199,6,Office Supplies,Storage,921,921,1194
AZ-2014-9876866,45,6,3,Office Supplies,Supplies,39,39,18
AZ-2014-9876866,307,74,3,Technology,Accessories,233,233,222
AZ-2014-9888408,632,-114,4,Furniture,Tables,746,746,-456
AZ-2014-9888408,16,6,1,Office Supplies,Art,10,10,6
AZ-2014-9888408,63,17,6,Office Supplies,Fasteners,46,46,102
AZ-2014-9888408,146,-63,3,Technology,Machines,209,209,-189
AZ-2014-9894212,112,15,2,Furniture,Chairs,97,97,30
AZ-2014-9904920,321,26,3,Technology,Copiers,295,295,78
AZ-2014-9905195,156,36,5,Office Supplies,Paper,120,120,180
AZ-2014-995232,511,194,3,Furniture,Chairs,317,317,582
AZ-2014-995232,185,48,4,Office Supplies,Art,137,137,192
AZ-2014-995232,765,8,6,Office Supplies,Storage,757,757,48
AZ-2014-9952627,536,91,1,Office Supplies,Appliances,445,445,91
AZ-2014-9952627,137,5,5,Office Supplies,Supplies,132,132,25
AZ-2014-9952627,757,371,2,Technology,Copiers,386,386,742
AZ-2014-9954741,106,12,3,Office Supplies,Appliances,94,94,36
AZ-2014-9954741,269,91,1,Technology,Machines,178,178,91
AZ-2014-9985991,95,5,2,Office Supplies,Art,90,90,10
BN-2011-1148567,140,-15,11,Office Supplies,Art,33,155,-165
BN-2011-1148567,44,-13,7,Office Supplies,Fasteners,24,57,-91
BN-2011-1148567,24,-6,4,Office Supplies,Labels,30,30,-24
BN-2011-1148567,104,-68,1,Office Supplies,Storage,172,172,-68
BN-2011-1148567,414,-373,6,Technology,Phones,787,787,-2238
BN-2011-1246931,382,0,3,Technology,Phones,382,382,0
BN-2011-1399750,254,73,3,Furniture,Chairs,181,181,219
BN-2011-1399750,40,2,3,Office Supplies,Art,7,38,6
BN-2011-1399750,48,19,4,Office Supplies,Binders,29,29,76
BN-2011-1399750,24,8,2,Office Supplies,Fasteners,16,16,16
BN-2011-1481332,19,-9,2,Furniture,Furnishings,28,28,-18
BN-2011-1481332,44,19,7,Office Supplies,Binders,25,25,133
BN-2011-1486107,148,54,2,Furniture,Chairs,94,94,108
BN-2011-1486107,44,16,1,Office Supplies,Supplies,28,28,16
BN-2011-1486107,1320,357,5,Technology,Machines,963,963,1785
BN-2011-1490641,173,-69,2,Technology,Phones,242,242,-138
BN-2011-1490837,243,104,5,Office Supplies,Art,139,139,520
BN-2011-1490837,91,-5,5,Office Supplies,Storage,96,96,-25
BN-2011-1490837,1093,306,8,Technology,Phones,787,787,2448
BN-2011-151204,54,-3,3,Office Supplies,Storage,57,57,-9
BN-2011-1627157,197,-24,2,Furniture,Bookcases,221,221,-48
BN-2011-1627157,56,-8,2,Office Supplies,Appliances,64,64,-16
BN-2011-1627157,41,-2,5,Office Supplies,Fasteners,43,43,-10
BN-2011-1627157,271,-183,11,Office Supplies,Storage,26,454,-2013
BN-2011-1627157,35,-19,2,Office Supplies,Supplies,54,54,-38
BN-2011-1677989,2017,0,9,Technology,Machines,2017,2017,0
BN-2011-1694636,838,-28,3,Office Supplies,Appliances,866,866,-84
BN-2011-1778575,123,-30,2,Furniture,Bookcases,153,153,-60
BN-2011-1778575,5,0,2,Office Supplies,Binders,5,5,0
BN-2011-1815779,254,5,2,Office Supplies,Storage,249,249,10
BN-2011-183687,126,-76,7,Office Supplies,Envelopes,202,202,-532
BN-2011-183687,17,-3,3,Office Supplies,Fasteners,20,20,-9
BN-2011-188092,117,40,5,Office Supplies,Art,77,77,200
BN-2011-188092,404,178,15,Office Supplies,Envelopes,72,226,2670
BN-2011-188092,305,-193,4,Office Supplies,Storage,498,498,-772
BN-2011-188092,202,-104,2,Technology,Phones,306,306,-208
BN-2011-1885034,77,-34,5,Office Supplies,Binders,111,111,-170
BN-2011-191610,58,-68,3,Office Supplies,Storage,126,126,-204
BN-2011-191610,25,-23,3,Office Supplies,Supplies,48,48,-69
BN-2011-1934094,182,-55,4,Technology,Phones,237,237,-220
BN-2011-1950255,81,41,3,Office Supplies,Art,40,40,123
BN-2011-1973226,327,-20,14,Office Supplies,Art,347,347,-280
BN-2011-1973226,39,-8,6,Office Supplies,Binders,24,47,-48
BN-2011-1973226,393,-306,3,Technology,Copiers,699,699,-918
BN-2011-2002150,39,-19,3,Office Supplies,Art,58,58,-57
BN-2011-2010578,87,-45,3,Furniture,Chairs,132,132,-135
BN-2011-2010578,17,-5,2,Office Supplies,Fasteners,22,22,-10
BN-2011-2010578,1441,-1268,8,Technology,Copiers,2709,2709,-10144
BN-2011-2028933,82,-53,3,Office Supplies,Art,135,135,-159
BN-2011-2093591,73,-4,3,Office Supplies,Art,77,77,-12
BN-2011-2113749,85,-59,4,Office Supplies,Supplies,144,144,-236
BN-2011-2113749,221,-221,3,Technology,Copiers,442,442,-663
BN-2011-2203231,44,-38,2,Office Supplies,Storage,82,82,-76
BN-2011-2207137,24,-4,4,Office Supplies,Art,28,28,-16
BN-2011-2207137,61,-47,7,Office Supplies,Storage,108,108,-329
BN-2011-2329209,231,95,3,Furniture,Chairs,136,136,285
BN-2011-2329209,66,16,5,Office Supplies,Fasteners,50,50,80
BN-2011-2343184,106,-23,3,Furniture,Furnishings,129,129,-69
BN-2011-2343184,79,35,5,Office Supplies,Envelopes,44,44,175
BN-2011-2343184,34,10,2,Office Supplies,Fasteners,24,24,20
BN-2011-2343184,11,5,1,Office Supplies,Labels,6,6,5
BN-2011-2343184,273,57,2,Office Supplies,Storage,216,216,114
BN-2011-2468159,46,-41,5,Office Supplies,Paper,87,87,-205
BN-2011-2468159,44,-8,2,Technology,Accessories,52,52,-16
BN-2011-2468159,550,-236,6,Technology,Copiers,786,786,-1416
BN-2011-2468159,89,-76,3,Technology,Machines,165,165,-228
BN-2011-2470191,10,-6,2,Office Supplies,Fasteners,16,16,-12
BN-2011-2470191,122,-47,4,Office Supplies,Storage,169,169,-188
BN-2011-2476139,1648,-627,8,Furniture,Bookcases,2275,2275,-5016
BN-2011-2502895,8,-6,2,Office Supplies,Labels,14,14,-12
BN-2011-2505496,60,-37,4,Office Supplies,Supplies,97,97,-148
BN-2011-251096,182,-46,2,Technology,Phones,228,228,-92
BN-2011-2579878,507,0,2,Office Supplies,Appliances,507,507,0
BN-2011-2650591,210,42,8,Office Supplies,Paper,168,168,336
BN-2011-2650591,524,-25,2,Technology,Machines,549,549,-50
BN-2011-2762940,965,-68,3,Technology,Copiers,1033,1033,-204
BN-2011-2779245,347,-25,6,Technology,Phones,372,372,-150
BN-2011-2807470,31,-14,5,Office Supplies,Art,45,45,-70
BN-2011-2819714,27,-22,2,Office Supplies,Art,49,49,-44
BN-2011-2819714,17,-1,2,Office Supplies,Storage,18,18,-2
BN-2011-28993,506,192,3,Furniture,Bookcases,314,314,576
BN-2011-28993,144,-37,4,Furniture,Furnishings,181,181,-148
BN-2011-28993,118,58,4,Office Supplies,Envelopes,60,60,232
BN-2011-2967562,40,-44,2,Furniture,Furnishings,84,84,-88
BN-2011-2986565,262,-204,2,Technology,Copiers,466,466,-408
BN-2011-303096,383,-77,1,Technology,Phones,460,460,-77
BN-2011-3032749,26,-14,5,Office Supplies,Binders,40,40,-70
BN-2011-3032749,215,-220,4,Office Supplies,Storage,435,435,-880
BN-2011-307477,4544,1868,11,Furniture,Chairs,2676,2676,20548
BN-2011-307477,277,0,1,Office Supplies,Appliances,277,277,0
BN-2011-307477,90,32,6,Office Supplies,Art,58,58,192
BN-2011-307477,284,43,2,Technology,Phones,241,241,86
BN-2011-3102464,1182,499,3,Furniture,Bookcases,683,683,1497
BN-2011-3102464,21,9,4,Office Supplies,Binders,12,12,36
BN-2011-3102464,13,6,2,Office Supplies,Labels,7,7,12
BN-2011-3102464,61,25,2,Office Supplies,Paper,36,36,50
BN-2011-3143758,56,-1,2,Office Supplies,Storage,57,57,-2
BN-2011-3143758,520,-96,5,Technology,Phones,616,616,-480
BN-2011-3154402,714,-143,3,Furniture,Chairs,857,857,-429
BN-2011-3154402,27,-15,2,Office Supplies,Storage,42,42,-30
BN-2011-315660,133,1,6,Office Supplies,Art,51,132,6
BN-2011-3210796,727,-400,2,Furniture,Tables,1127,1127,-800
BN-2011-3231719,3119,1528,7,Furniture,Tables,1591,1591,10696
BN-2011-3231719,1553,776,9,Technology,Copiers,777,777,6984
BN-2011-3243410,205,-90,2,Office Supplies,Storage,295,295,-180
BN-2011-3248724,987,-1012,6,Furniture,Bookcases,1999,1999,-6072
BN-2011-3248724,116,-56,5,Office Supplies,Art,172,172,-280
BN-2011-326585,28,2,2,Office Supplies,Fasteners,26,26,4
BN-2011-326585,451,-75,12,Office Supplies,Storage,526,526,-900
BN-2011-3405497,13,-2,2,Office Supplies,Binders,15,15,-4
BN-2011-3508590,1262,-42,3,Furniture,Chairs,1304,1304,-126
BN-2011-357064,53,-36,5,Office Supplies,Envelopes,89,89,-180
BN-2011-3572647,195,66,3,Furniture,Chairs,129,129,198
BN-2011-3572647,48,-1,2,Office Supplies,Art,49,49,-2
BN-2011-3572647,58,22,4,Office Supplies,Envelopes,36,36,88
BN-2011-3572647,74,32,2,Office Supplies,Supplies,42,42,64
BN-2011-3654306,1001,120,4,Furniture,Bookcases,203,881,480
BN-2011-3654306,253,-25,2,Office Supplies,Storage,278,278,-50
BN-2011-3654306,276,14,2,Technology,Phones,262,262,28
BN-2011-3728079,533,0,6,Furniture,Furnishings,533,533,0
BN-2011-3728079,120,-41,3,Technology,Phones,161,161,-123
BN-2011-3742620,248,-112,3,Office Supplies,Storage,360,360,-336
BN-2011-3770060,17,-8,3,Office Supplies,Labels,25,25,-24
BN-2011-377186,61,-14,4,Office Supplies,Storage,75,75,-56
BN-2011-3829449,12,4,1,Office Supplies,Labels,8,8,4
BN-2011-3829449,392,-44,9,Office Supplies,Storage,436,436,-396
BN-2011-383161,32,8,5,Office Supplies,Binders,24,24,40
BN-2011-383161,1244,-14,7,Office Supplies,Storage,1258,1258,-98
BN-2011-3910885,50,3,2,Office Supplies,Art,47,47,6
BN-2011-3910885,23,9,1,Office Supplies,Envelopes,14,14,9
BN-2011-3910885,952,-32,5,Office Supplies,Storage,984,984,-160
BN-2011-3962140,13,-4,2,Office Supplies,Envelopes,17,17,-8
BN-2011-4029264,785,270,2,Furniture,Bookcases,515,515,540
BN-2011-4029264,60,-3,4,Office Supplies,Storage,63,63,-12
BN-2011-4029264,1293,233,5,Technology,Accessories,1060,1060,1165
BN-2011-408191,728,-82,2,Furniture,Chairs,810,810,-164
BN-2011-408191,127,19,3,Furniture,Furnishings,108,108,57
BN-2011-4097137,411,-58,2,Furniture,Bookcases,469,469,-116
BN-2011-4097137,182,-114,10,Furniture,Furnishings,210,296,-1140
BN-2011-4097137,855,-376,3,Office Supplies,Appliances,1231,1231,-1128
BN-2011-4097137,159,-39,10,Office Supplies,Art,139,198,-390
BN-2011-4097137,7,-3,2,Office Supplies,Binders,10,10,-6
BN-2011-4249147,122,-8,2,Office Supplies,Appliances,130,130,-16
BN-2011-4249147,330,89,13,Office Supplies,Art,241,241,1157
BN-2011-4260093,224,63,8,Office Supplies,Binders,62,161,504
BN-2011-4260093,1016,364,7,Office Supplies,Storage,568,652,2548
BN-2011-4315830,93,7,7,Office Supplies,Binders,46,86,49
BN-2011-4315830,58,29,3,Office Supplies,Fasteners,29,29,87
BN-2011-4315830,490,-114,4,Office Supplies,Storage,604,604,-456
BN-2011-4328697,101,31,2,Furniture,Furnishings,70,70,62
BN-2011-4328697,29,14,4,Office Supplies,Envelopes,15,15,56
BN-2011-4328697,325,-4,2,Technology,Copiers,329,329,-8
BN-2011-4396152,158,-70,11,Office Supplies,Binders,84,228,-770
BN-2011-4438698,1363,-327,3,Furniture,Tables,1690,1690,-981
BN-2011-4438698,285,14,6,Office Supplies,Art,271,271,84
BN-2011-4438698,344,-190,10,Office Supplies,Storage,534,534,-1900
BN-2011-452629,25,-7,3,Office Supplies,Art,32,32,-21
BN-2011-4542382,97,37,3,Office Supplies,Art,60,60,111
BN-2011-4542382,263,63,5,Office Supplies,Binders,200,200,315
BN-2011-4542382,53,18,4,Office Supplies,Fasteners,35,35,72
BN-2011-4542382,812,-27,7,Office Supplies,Storage,839,839,-189
BN-2011-4542382,274,84,4,Technology,Phones,190,190,336
BN-2011-4708578,151,9,3,Office Supplies,Binders,142,142,27
BN-2011-4708578,165,-110,2,Office Supplies,Storage,275,275,-220
BN-2011-4708578,713,14,5,Technology,Copiers,699,699,70
BN-2011-4718947,243,119,4,Office Supplies,Storage,124,124,476
BN-2011-473171,211,-90,6,Furniture,Chairs,301,301,-540
BN-2011-4790136,171,-48,7,Office Supplies,Binders,219,219,-336
BN-2011-4861178,371,-231,10,Technology,Accessories,44,602,-2310
BN-2011-486854,28,-1,1,Office Supplies,Storage,29,29,-1
BN-2011-4899110,132,-7,2,Technology,Phones,139,139,-14
BN-2011-4913858,9,-3,3,Office Supplies,Binders,12,12,-9
BN-2011-4913858,22,-12,4,Office Supplies,Labels,34,34,-48
BN-2011-4913858,50,-38,2,Office Supplies,Paper,88,88,-76
BN-2011-4913858,198,-131,2,Office Supplies,Storage,329,329,-262
BN-2011-493079,469,-103,7,Furniture,Chairs,572,572,-721
BN-2011-493079,57,-40,2,Office Supplies,Art,97,97,-80
BN-2011-493079,55,-34,2,Office Supplies,Storage,89,89,-68
BN-2011-493873,875,-577,4,Furniture,Bookcases,1452,1452,-2308
BN-2011-493873,273,-500,3,Furniture,Tables,773,773,-1500
BN-2011-4950607,87,-106,2,Furniture,Furnishings,193,193,-212
BN-2011-5006178,90,-88,5,Furniture,Furnishings,178,178,-440
BN-2011-5006178,52,-34,2,Office Supplies,Art,86,86,-68
BN-2011-5006178,128,-54,5,Office Supplies,Binders,182,182,-270
BN-2011-5036253,55,-44,8,Office Supplies,Fasteners,99,99,-352
BN-2011-5132700,242,102,2,Furniture,Bookcases,140,140,204
BN-2011-5132700,21,11,3,Office Supplies,Binders,10,10,33
BN-2011-5132700,39,0,6,Office Supplies,Labels,39,39,0
BN-2011-5132700,290,-136,9,Office Supplies,Storage,426,426,-1224
BN-2011-5141814,43,-20,3,Office Supplies,Storage,63,63,-60
BN-2011-5228628,156,-22,2,Furniture,Furnishings,178,178,-44
BN-2011-5239456,746,182,2,Furniture,Bookcases,564,564,364
BN-2011-5290627,45,-34,2,Furniture,Chairs,79,79,-68
BN-2011-5294325,84,19,3,Office Supplies,Art,19,65,57
BN-2011-5294325,256,-102,3,Office Supplies,Storage,358,358,-306
BN-2011-5294325,698,209,6,Technology,Accessories,489,489,1254
BN-2011-5294325,601,-371,6,Technology,Phones,972,972,-2226
BN-2011-5307099,185,-93,3,Technology,Phones,278,278,-279
BN-2011-5443120,205,-127,8,Office Supplies,Art,332,332,-1016
BN-2011-5443120,17,-5,2,Office Supplies,Envelopes,22,22,-10
BN-2011-5491702,92,-28,3,Office Supplies,Appliances,120,120,-84
BN-2011-5491702,96,0,6,Office Supplies,Art,96,96,0
BN-2011-5491702,4,-2,1,Office Supplies,Binders,6,6,-2
BN-2011-5491702,20,-20,3,Office Supplies,Fasteners,40,40,-60
BN-2011-5491702,27,-20,1,Office Supplies,Storage,47,47,-20
BN-2011-553410,508,-91,6,Furniture,Bookcases,599,599,-546
BN-2011-553410,5,0,2,Office Supplies,Binders,5,5,0
BN-2011-553410,11,-8,2,Office Supplies,Fasteners,19,19,-16
BN-2011-555099,21,6,2,Office Supplies,Fasteners,15,15,12
BN-2011-555099,32,8,3,Office Supplies,Storage,24,24,24
BN-2011-5579284,41,-7,1,Furniture,Furnishings,48,48,-7
BN-2011-5624168,27,3,1,Office Supplies,Binders,24,24,3
BN-2011-5624168,30,4,3,Office Supplies,Labels,26,26,12
BN-2011-5624168,1060,-115,10,Office Supplies,Storage,539,1175,-1150
BN-2011-5636693,956,-45,7,Technology,Machines,1001,1001,-315
BN-2011-5636693,232,-41,2,Technology,Phones,273,273,-82
BN-2011-5662753,180,-90,7,Office Supplies,Binders,270,270,-630
BN-2011-5672017,124,40,5,Office Supplies,Art,84,84,200
BN-2011-5672017,120,4,9,Office Supplies,Binders,116,116,36
BN-2011-5672017,25,5,2,Office Supplies,Fasteners,20,20,10
BN-2011-5751868,238,0,7,Technology,Phones,238,238,0
BN-2011-5791319,607,-304,4,Furniture,Tables,911,911,-1216
BN-2011-5791319,159,6,4,Technology,Accessories,153,153,24
BN-2011-5791319,729,-134,7,Technology,Phones,863,863,-938
BN-2011-5873722,53,-30,9,Office Supplies,Labels,83,83,-270
BN-2011-5873722,98,-86,3,Technology,Phones,184,184,-258
BN-2011-5897988,1814,653,5,Furniture,Bookcases,1161,1161,3265
BN-2011-5897988,29,0,2,Office Supplies,Storage,29,29,0
BN-2011-5897988,373,60,3,Technology,Copiers,313,313,180
BN-2011-5897988,263,102,2,Technology,Phones,161,161,204
BN-2011-5999704,122,-24,7,Office Supplies,Supplies,146,146,-168
BN-2011-6008282,1381,-414,6,Furniture,Chairs,1795,1795,-2484
BN-2011-602308,46,-38,11,Office Supplies,Envelopes,84,84,-418
BN-2011-6142692,956,-96,4,Technology,Machines,1052,1052,-384
BN-2011-6142692,738,-8,6,Technology,Phones,746,746,-48
BN-2011-6162681,2229,-754,7,Furniture,Tables,2983,2983,-5278
BN-2011-6178410,73,-12,2,Technology,Phones,85,85,-24
BN-2011-6425274,22,-21,3,Office Supplies,Fasteners,43,43,-63
BN-2011-6425274,39,-59,4,Office Supplies,Storage,98,98,-236
BN-2011-6464780,98,12,4,Office Supplies,Art,14,86,48
BN-2011-6464780,7,3,1,Office Supplies,Binders,4,4,3
BN-2011-6498909,281,3,2,Office Supplies,Storage,278,278,6
BN-2011-6545829,206,-21,2,Furniture,Chairs,227,227,-42
BN-2011-6545829,22,5,2,Office Supplies,Art,17,17,10
BN-2011-6545829,19,8,4,Office Supplies,Binders,11,11,32
BN-2011-6545829,137,-6,1,Technology,Phones,143,143,-6
BN-2011-6588034,138,22,6,Office Supplies,Binders,95,116,132
BN-2011-6627390,1314,-631,6,Furniture,Bookcases,1945,1945,-3786
BN-2011-6627390,15,-4,2,Office Supplies,Art,19,19,-8
BN-2011-6722454,570,-217,3,Technology,Copiers,787,787,-651
BN-2011-6893107,497,-290,6,Technology,Phones,787,787,-1740
BN-2011-6956959,29,-1,2,Office Supplies,Binders,30,30,-2
BN-2011-7016974,18,-17,3,Office Supplies,Fasteners,35,35,-51
BN-2011-7087921,91,-62,6,Office Supplies,Art,153,153,-372
BN-2011-7176889,51,-32,2,Office Supplies,Art,83,83,-64
BN-2011-7176889,146,-128,2,Technology,Copiers,274,274,-256
BN-2011-7253620,747,-90,5,Technology,Machines,837,837,-450
BN-2011-7263458,349,-21,3,Technology,Phones,370,370,-63
BN-2011-7286308,170,-82,3,Furniture,Furnishings,252,252,-246
BN-2011-7314925,46,-22,4,Office Supplies,Art,29,68,-88
BN-2011-7314925,36,-10,3,Office Supplies,Paper,46,46,-30
BN-2011-7407039,45,-26,3,Office Supplies,Paper,71,71,-78
BN-2011-743949,74,-63,1,Furniture,Bookcases,137,137,-63
BN-2011-7459578,208,-191,3,Technology,Phones,399,399,-573
BN-2011-74934,140,-25,4,Office Supplies,Appliances,165,165,-100
BN-2011-7569474,175,24,5,Furniture,Furnishings,151,151,120
BN-2011-7569474,154,-96,6,Office Supplies,Art,250,250,-576
BN-2011-7580951,2040,-113,4,Office Supplies,Appliances,2153,2153,-452
BN-2011-7621077,19,-4,2,Office Supplies,Art,23,23,-8
BN-2011-7628560,1593,653,5,Technology,Copiers,940,940,3265
BN-2011-764592,102,-25,3,Office Supplies,Storage,127,127,-75
BN-2011-764592,524,5,2,Technology,Copiers,519,519,10
BN-2011-7646735,17,-7,2,Office Supplies,Paper,24,24,-14
BN-2011-7685910,237,83,8,Office Supplies,Art,154,154,664
BN-2011-7685910,54,-3,3,Office Supplies,Storage,57,57,-9
BN-2011-7723992,348,-61,3,Technology,Phones,409,409,-183
BN-2011-7737747,627,-135,2,Furniture,Tables,762,762,-270
BN-2011-7796258,388,-357,3,Technology,Accessories,745,745,-1071
BN-2011-7883641,142,-152,4,Furniture,Chairs,130,294,-608
BN-2011-7883641,41,3,4,Office Supplies,Fasteners,38,38,12
BN-2011-7883641,54,8,5,Office Supplies,Labels,46,46,40
BN-2011-7883641,55,3,3,Office Supplies,Paper,52,52,9
BN-2011-7884993,684,-24,11,Technology,Phones,708,708,-264
BN-2011-7943667,443,-58,8,Technology,Phones,501,501,-464
BN-2011-7963759,744,-353,4,Furniture,Chairs,1097,1097,-1412
BN-2011-7963759,706,-52,21,Office Supplies,Storage,45,758,-1092
BN-2011-7963759,393,-190,5,Technology,Phones,583,583,-950
BN-2011-801002,51,-15,2,Office Supplies,Binders,66,66,-30
BN-2011-8011625,4229,619,12,Office Supplies,Appliances,968,3610,7428
BN-2011-8011625,145,-3,3,Office Supplies,Art,148,148,-9
BN-2011-8011625,21,3,2,Office Supplies,Envelopes,18,18,6
BN-2011-8011625,71,32,3,Office Supplies,Paper,39,39,96
BN-2011-8019925,284,-10,2,Technology,Copiers,294,294,-20
BN-2011-8153992,218,-10,5,Furniture,Furnishings,228,228,-50
BN-2011-8153992,36,13,2,Office Supplies,Art,23,23,26
BN-2011-8153992,31,6,6,Office Supplies,Binders,25,25,36
BN-2011-815729,115,-39,3,Office Supplies,Appliances,154,154,-117
BN-2011-8172607,897,-198,7,Technology,Accessories,1095,1095,-1386
BN-2011-8172607,117,-61,2,Technology,Machines,178,178,-122
BN-2011-8172607,981,-118,3,Technology,Phones,1099,1099,-354
BN-2011-8211228,17,-12,3,Office Supplies,Labels,29,29,-36
BN-2011-8211228,84,-55,1,Technology,Phones,139,139,-55
BN-2011-8231931,87,-4,5,Office Supplies,Supplies,91,91,-20
BN-2011-8234232,44,-32,3,Office Supplies,Art,76,76,-96
BN-2011-8234232,39,-17,4,Office Supplies,Paper,56,56,-68
BN-2011-8234232,610,-232,6,Office Supplies,Storage,842,842,-1392
BN-2011-8274717,106,-8,3,Furniture,Furnishings,114,114,-24
BN-2011-827720,26,-8,2,Office Supplies,Art,34,34,-16
BN-2011-8337636,101,5,5,Furniture,Furnishings,96,96,25
BN-2011-8337636,125,-105,3,Office Supplies,Appliances,230,230,-315
BN-2011-8337636,50,-22,2,Office Supplies,Binders,72,72,-44
BN-2011-8337636,90,0,4,Office Supplies,Paper,90,90,0
BN-2011-8337636,388,-357,3,Technology,Accessories,745,745,-1071
BN-2011-8337636,243,-175,6,Technology,Machines,418,418,-1050
BN-2011-8382355,47,-40,2,Office Supplies,Storage,87,87,-80
BN-2011-8431343,146,18,3,Office Supplies,Storage,128,128,54
BN-2011-8431343,683,-96,3,Technology,Machines,779,779,-288
BN-2011-8574171,47,-60,2,Furniture,Chairs,107,107,-120
BN-2011-8607391,668,-31,3,Technology,Copiers,699,699,-93
BN-2011-8749099,470,-31,2,Technology,Machines,501,501,-62
BN-2011-886514,50,14,3,Office Supplies,Binders,36,36,42
BN-2011-886514,604,-7,5,Office Supplies,Storage,611,611,-35
BN-2011-886514,432,181,5,Technology,Machines,251,251,905
BN-2011-8948847,47,-4,5,Office Supplies,Envelopes,51,51,-20
BN-2011-8948847,6,-6,1,Office Supplies,Fasteners,12,12,-6
BN-2011-8948847,246,-143,7,Technology,Phones,140,389,-1001
BN-2011-8990099,311,87,6,Furniture,Furnishings,224,224,522
BN-2011-8990099,196,61,7,Office Supplies,Art,77,135,427
BN-2011-8990099,70,4,3,Office Supplies,Envelopes,66,66,12
BN-2011-8990099,56,17,2,Office Supplies,Paper,39,39,34
BN-2011-8990099,53,3,3,Office Supplies,Storage,50,50,9
BN-2011-9020794,40,-33,5,Office Supplies,Binders,73,73,-165
BN-2011-9020794,23,-5,1,Office Supplies,Envelopes,28,28,-5
BN-2011-9080680,398,-13,3,Furniture,Bookcases,411,411,-39
BN-2011-9297999,135,-8,2,Office Supplies,Storage,143,143,-16
BN-2011-9336144,248,8,2,Office Supplies,Storage,240,240,16
BN-2011-9336144,379,140,1,Technology,Copiers,239,239,140
BN-2011-9474783,92,26,3,Office Supplies,Binders,66,66,78
BN-2011-9556882,28,7,2,Office Supplies,Fasteners,21,21,14
BN-2011-9556882,425,0,3,Technology,Phones,425,425,0
BN-2011-9771202,1253,-42,3,Furniture,Chairs,1295,1295,-126
BN-2011-980083,265,3,5,Furniture,Furnishings,262,262,15
BN-2011-980083,30,5,3,Office Supplies,Storage,25,25,15
BN-2011-980083,204,31,3,Technology,Phones,173,173,93
BN-2011-9883465,145,-52,9,Office Supplies,Supplies,197,197,-468
BN-2011-9985747,35,-22,3,Office Supplies,Art,57,57,-66
BN-2012-1029771,724,-217,4,Furniture,Bookcases,941,941,-868
BN-2012-1029771,180,-54,2,Furniture,Chairs,234,234,-108
BN-2012-1069240,27,7,1,Office Supplies,Art,20,20,7
BN-2012-1069240,109,-6,6,Office Supplies,Storage,115,115,-36
BN-2012-1106280,62,14,2,Office Supplies,Paper,48,48,28
BN-2012-1106280,40,2,2,Office Supplies,Storage,38,38,4
BN-2012-1206037,29,-27,4,Office Supplies,Binders,56,56,-108
BN-2012-1206037,205,-90,8,Office Supplies,Envelopes,295,295,-720
BN-2012-1206890,200,-260,3,Furniture,Chairs,460,460,-780
BN-2012-1206890,11,-9,2,Office Supplies,Art,20,20,-18
BN-2012-1206890,14,-12,2,Office Supplies,Fasteners,26,26,-24
BN-2012-1276704,26,-2,2,Office Supplies,Art,28,28,-4
BN-2012-1276704,648,57,5,Technology,Copiers,591,591,285
BN-2012-1321856,240,-535,3,Furniture,Tables,775,775,-1605
BN-2012-1321856,22,0,3,Office Supplies,Fasteners,22,22,0
BN-2012-1321856,145,-9,6,Office Supplies,Storage,154,154,-54
BN-2012-1321856,36,-18,3,Office Supplies,Supplies,54,54,-54
BN-2012-1349610,555,-1925,4,Furniture,Tables,2480,2480,-7700
BN-2012-1365055,59,-16,2,Office Supplies,Storage,75,75,-32
BN-2012-1365055,637,261,2,Technology,Copiers,376,376,522
BN-2012-141614,30,-18,3,Furniture,Furnishings,48,48,-54
BN-2012-1453436,43,4,3,Office Supplies,Fasteners,39,39,12
BN-2012-1467003,140,34,3,Furniture,Chairs,106,106,102
BN-2012-1467003,56,27,3,Office Supplies,Fasteners,29,29,81
BN-2012-1644074,51,-17,4,Office Supplies,Art,68,68,-68
BN-2012-1679258,43,-5,2,Office Supplies,Storage,48,48,-10
BN-2012-1710489,214,-205,3,Technology,Copiers,419,419,-615
BN-2012-1757975,426,90,1,Furniture,Chairs,336,336,90
BN-2012-1777533,133,-119,2,Furniture,Chairs,252,252,-238
BN-2012-1800160,69,-16,2,Office Supplies,Storage,85,85,-32
BN-2012-183691,234,-229,7,Furniture,Chairs,463,463,-1603
BN-2012-183691,9,0,4,Office Supplies,Binders,9,9,0
BN-2012-183691,82,-2,4,Office Supplies,Supplies,84,84,-8
BN-2012-1840442,30,3,2,Office Supplies,Binders,27,27,6
BN-2012-1840442,225,67,5,Office Supplies,Paper,158,158,335
BN-2012-1840442,62,1,3,Office Supplies,Storage,61,61,3
BN-2012-1840442,426,0,3,Technology,Phones,426,426,0
BN-2012-1899005,86,-82,4,Furniture,Chairs,168,168,-328
BN-2012-1971141,108,-183,2,Technology,Phones,291,291,-366
BN-2012-2002829,410,-212,5,Technology,Phones,622,622,-1060
BN-2012-2024593,900,-10,2,Office Supplies,Appliances,910,910,-20
BN-2012-205322,53,-2,3,Office Supplies,Storage,55,55,-6
BN-2012-2095072,130,8,5,Office Supplies,Envelopes,88,122,40
BN-2012-2095072,758,126,4,Office Supplies,Storage,632,632,504
BN-2012-2195674,1257,-30,8,Technology,Phones,1287,1287,-240
BN-2012-2217605,112,41,7,Office Supplies,Art,71,71,287
BN-2012-2217605,29,12,3,Office Supplies,Labels,17,17,36
BN-2012-2217605,85,40,3,Office Supplies,Supplies,45,45,120
BN-2012-2217605,1188,95,4,Technology,Copiers,1093,1093,380
BN-2012-2247108,3063,-142,11,Furniture,Tables,3205,3205,-1562
BN-2012-2362845,907,-30,7,Furniture,Bookcases,937,937,-210
BN-2012-2380849,610,-232,6,Office Supplies,Storage,842,842,-1392
BN-2012-2380849,83,-55,6,Office Supplies,Supplies,138,138,-330
BN-2012-2480947,189,45,11,Office Supplies,Art,54,144,495
BN-2012-2480947,67,27,5,Office Supplies,Binders,40,40,135
BN-2012-2480947,62,19,4,Office Supplies,Fasteners,43,43,76
BN-2012-2480947,57,14,5,Office Supplies,Labels,43,43,70
BN-2012-2480947,918,-398,9,Technology,Machines,1316,1316,-3582
BN-2012-2480947,97,-29,2,Technology,Phones,126,126,-58
BN-2012-2497362,197,22,4,Office Supplies,Binders,175,175,88
BN-2012-2497362,108,40,11,Office Supplies,Fasteners,68,68,440
BN-2012-2518172,294,-64,3,Technology,Machines,358,358,-192
BN-2012-256121,118,27,3,Furniture,Furnishings,91,91,81
BN-2012-256121,915,-599,5,Furniture,Tables,1514,1514,-2995
BN-2012-256121,692,-15,3,Technology,Machines,707,707,-45
BN-2012-2590237,28,0,1,Office Supplies,Binders,28,28,0
BN-2012-2590237,2017,0,9,Technology,Machines,2017,2017,0
BN-2012-2590237,1082,89,2,Technology,Phones,993,993,178
BN-2012-26008,159,-29,6,Furniture,Chairs,188,188,-174
BN-2012-26008,12,-6,2,Office Supplies,Fasteners,18,18,-12
BN-2012-26008,68,-40,5,Office Supplies,Paper,13,108,-200
BN-2012-26008,249,-149,4,Technology,Phones,398,398,-596
BN-2012-2613317,62,8,2,Office Supplies,Paper,54,54,16
BN-2012-2769143,179,-61,1,Technology,Copiers,240,240,-61
BN-2012-2769143,112,-94,3,Technology,Machines,206,206,-282
BN-2012-2772925,158,-44,2,Office Supplies,Storage,202,202,-88
BN-2012-2772925,1602,-1346,13,Technology,Accessories,2948,2948,-17498
BN-2012-2790989,88,15,2,Furniture,Furnishings,73,73,30
BN-2012-2790989,174,-104,2,Technology,Machines,278,278,-208
BN-2012-2793223,40,19,2,Furniture,Furnishings,21,21,38
BN-2012-2793223,79,2,3,Office Supplies,Art,77,77,6
BN-2012-2820764,85,35,5,Office Supplies,Fasteners,50,50,175
BN-2012-2820764,389,-13,7,Office Supplies,Storage,402,402,-91
BN-2012-282607,150,-3,1,Furniture,Chairs,153,153,-3
BN-2012-282607,79,6,5,Office Supplies,Binders,73,73,30
BN-2012-282607,17,2,2,Office Supplies,Labels,15,15,4
BN-2012-282607,471,-45,5,Office Supplies,Storage,8,516,-225
BN-2012-282607,227,109,6,Office Supplies,Supplies,118,118,654
BN-2012-2836237,240,67,9,Office Supplies,Art,173,173,603
BN-2012-2836237,916,194,6,Office Supplies,Storage,304,722,1164
BN-2012-285450,303,88,6,Office Supplies,Art,215,215,528
BN-2012-285450,18,4,2,Office Supplies,Binders,14,14,8
BN-2012-2859284,38,-9,3,Furniture,Furnishings,47,47,-27
BN-2012-2885506,81,-9,4,Office Supplies,Art,90,90,-36
BN-2012-2935339,1273,-993,7,Furniture,Bookcases,2266,2266,-6951
BN-2012-2935339,11,-5,2,Office Supplies,Storage,16,16,-10
BN-2012-3059145,41,-3,1,Office Supplies,Art,44,44,-3
BN-2012-3059145,92,-1,4,Office Supplies,Supplies,93,93,-4
BN-2012-3187159,51,-21,2,Office Supplies,Art,72,72,-42
BN-2012-3254922,2544,1094,4,Technology,Phones,1450,1450,4376
BN-2012-3388525,17,-14,3,Office Supplies,Fasteners,31,31,-42
BN-2012-3388525,100,-64,2,Technology,Accessories,164,164,-128
BN-2012-3390552,229,16,6,Technology,Accessories,213,213,96
BN-2012-3544150,11,2,1,Office Supplies,Labels,9,9,2
BN-2012-3544150,984,-11,8,Technology,Phones,995,995,-88
BN-2012-3566851,32,9,1,Office Supplies,Supplies,23,23,9
BN-2012-3566851,730,-60,7,Technology,Copiers,790,790,-420
BN-2012-3586666,74,-31,3,Furniture,Chairs,105,105,-93
BN-2012-3611011,171,-72,7,Office Supplies,Art,243,243,-504
BN-2012-3616374,191,56,7,Office Supplies,Art,107,135,392
BN-2012-3616374,30,-1,3,Office Supplies,Storage,31,31,-3
BN-2012-3780400,728,-82,2,Furniture,Chairs,810,810,-164
BN-2012-3780400,297,104,3,Office Supplies,Appliances,193,193,312
BN-2012-3858400,99,-77,4,Office Supplies,Binders,176,176,-308
BN-2012-3858400,12,-9,3,Office Supplies,Labels,21,21,-27
BN-2012-3858400,117,-89,6,Office Supplies,Supplies,206,206,-534
BN-2012-3872886,1246,-125,3,Furniture,Chairs,1371,1371,-375
BN-2012-3872886,83,12,3,Office Supplies,Art,71,71,36
BN-2012-3872886,209,84,7,Office Supplies,Binders,125,125,588
BN-2012-3874794,16,-3,3,Office Supplies,Fasteners,19,19,-9
BN-2012-3923455,604,-7,5,Office Supplies,Storage,611,611,-35
BN-2012-3932885,591,219,3,Furniture,Bookcases,372,372,657
BN-2012-3932885,414,153,8,Office Supplies,Art,261,261,1224
BN-2012-3932885,60,3,3,Office Supplies,Storage,57,57,9
BN-2012-3932885,76,5,2,Technology,Accessories,71,71,10
BN-2012-3975378,96,-87,5,Furniture,Chairs,183,183,-435
BN-2012-3975378,191,2,3,Office Supplies,Storage,146,189,6
BN-2012-4057462,402,-45,5,Furniture,Chairs,447,447,-225
BN-2012-4057462,242,100,2,Office Supplies,Storage,142,142,200
BN-2012-4184699,1128,-127,3,Furniture,Chairs,1255,1255,-381
BN-2012-4235969,1285,414,3,Furniture,Chairs,871,871,1242
BN-2012-4235969,66,12,5,Office Supplies,Labels,54,54,60
BN-2012-4235969,655,237,7,Office Supplies,Storage,355,418,1659
BN-2012-4253204,147,4,3,Office Supplies,Storage,143,143,12
BN-2012-4363954,53,-5,3,Furniture,Furnishings,58,58,-15
BN-2012-4383026,134,25,8,Office Supplies,Paper,109,109,200
BN-2012-4383026,136,41,3,Technology,Accessories,95,95,123
BN-2012-4385280,117,-72,4,Office Supplies,Storage,189,189,-288
BN-2012-4439076,245,22,5,Furniture,Furnishings,223,223,110
BN-2012-4439076,12,-5,1,Office Supplies,Storage,17,17,-5
BN-2012-4439076,362,-121,7,Technology,Machines,483,483,-847
BN-2012-4476459,93,14,2,Office Supplies,Art,79,79,28
BN-2012-4476459,510,-332,8,Office Supplies,Storage,687,842,-2656
BN-2012-4615996,51,-9,6,Office Supplies,Fasteners,60,60,-54
BN-2012-4716466,21,6,2,Office Supplies,Storage,15,15,12
BN-2012-4720977,44,-1,1,Furniture,Chairs,45,45,-1
BN-2012-4720977,259,8,5,Office Supplies,Art,251,251,40
BN-2012-4720977,20,3,1,Office Supplies,Envelopes,17,17,3
BN-2012-4720977,832,-19,10,Office Supplies,Storage,83,851,-190
BN-2012-4743725,454,126,3,Furniture,Bookcases,328,328,378
BN-2012-4743725,571,-51,5,Office Supplies,Storage,622,622,-255
BN-2012-4743725,332,0,5,Technology,Machines,332,332,0
BN-2012-4750589,84,3,7,Office Supplies,Binders,81,81,21
BN-2012-4750589,57,0,5,Office Supplies,Fasteners,57,57,0
BN-2012-4750589,49,16,1,Office Supplies,Storage,33,33,16
BN-2012-4774400,103,-6,2,Furniture,Chairs,109,109,-12
BN-2012-4774400,316,60,6,Office Supplies,Art,256,256,360
BN-2012-4774400,22,3,2,Office Supplies,Labels,19,19,6
BN-2012-4774400,357,139,2,Office Supplies,Storage,218,218,278
BN-2012-4936189,23,-8,3,Office Supplies,Art,31,31,-24
BN-2012-5098114,85,-5,10,Office Supplies,Storage,90,90,-50
BN-2012-5184619,155,-31,5,Office Supplies,Storage,186,186,-155
BN-2012-5195866,265,26,6,Furniture,Furnishings,239,239,156
BN-2012-5195866,559,-55,4,Technology,Copiers,346,614,-220
BN-2012-5227523,261,-68,8,Technology,Phones,329,329,-544
BN-2012-5235774,141,-57,4,Furniture,Furnishings,198,198,-228
BN-2012-5235774,67,6,3,Office Supplies,Art,61,61,18
BN-2012-5238794,39,-16,7,Office Supplies,Binders,30,55,-112
BN-2012-5238794,47,-11,7,Office Supplies,Envelopes,58,58,-77
BN-2012-5238794,86,-63,9,Office Supplies,Paper,63,149,-567
BN-2012-5238794,2119,-1752,13,Technology,Copiers,297,3871,-22776
BN-2012-5238794,207,-120,3,Technology,Phones,327,327,-360
BN-2012-5288178,87,-42,3,Office Supplies,Storage,129,129,-126
BN-2012-5288178,179,-61,1,Technology,Copiers,240,240,-61
BN-2012-5319905,70,-271,7,Furniture,Furnishings,341,341,-1897
BN-2012-5381064,443,74,4,Furniture,Bookcases,369,369,296
BN-2012-5381064,230,70,8,Office Supplies,Art,52,160,560
BN-2012-5381064,709,-100,5,Technology,Phones,809,809,-500
BN-2012-5394527,97,24,2,Furniture,Chairs,73,73,48
BN-2012-5394527,140,68,5,Office Supplies,Paper,72,72,340
BN-2012-5394527,1361,462,8,Technology,Machines,899,899,3696
BN-2012-5433967,153,-52,4,Office Supplies,Appliances,205,205,-208
BN-2012-5489653,30,-1,3,Office Supplies,Storage,31,31,-3
BN-2012-5523368,147,-32,2,Technology,Machines,179,179,-64
BN-2012-5546436,344,-106,1,Furniture,Tables,450,450,-106
BN-2012-5608207,186,-157,5,Technology,Machines,343,343,-785
BN-2012-5777866,816,-96,3,Technology,Copiers,912,912,-288
BN-2012-5839370,1451,-363,8,Furniture,Tables,1814,1814,-2904
BN-2012-5839370,211,40,7,Office Supplies,Binders,171,171,280
BN-2012-5924250,598,-49,4,Technology,Machines,647,647,-196
BN-2012-5986859,71,11,6,Office Supplies,Binders,44,60,66
BN-2012-6027160,17,-8,4,Office Supplies,Binders,25,25,-32
BN-2012-6027160,126,-78,7,Office Supplies,Supplies,137,204,-546
BN-2012-6248125,183,-140,4,Furniture,Chairs,323,323,-560
BN-2012-6248125,47,-11,7,Office Supplies,Binders,58,58,-77
BN-2012-6348676,20,-17,3,Office Supplies,Binders,37,37,-51
BN-2012-6348676,83,-48,2,Technology,Phones,131,131,-96
BN-2012-6527572,157,-204,3,Furniture,Chairs,361,361,-612
BN-2012-6527572,948,66,5,Technology,Copiers,882,882,330
BN-2012-6672133,37,9,3,Office Supplies,Fasteners,28,28,27
BN-2012-6672133,65,-6,3,Office Supplies,Storage,71,71,-18
BN-2012-6728317,668,-110,3,Technology,Copiers,778,778,-330
BN-2012-6754964,13,3,2,Office Supplies,Binders,10,10,6
BN-2012-6754964,83,34,5,Office Supplies,Supplies,49,49,170
BN-2012-6756198,510,-119,6,Office Supplies,Storage,629,629,-714
BN-2012-6776208,612,-65,2,Technology,Copiers,677,677,-130
BN-2012-6784776,46,13,3,Office Supplies,Binders,33,33,39
BN-2012-6784776,180,39,5,Office Supplies,Supplies,141,141,195
BN-2012-6872089,264,-21,6,Office Supplies,Storage,285,285,-126
BN-2012-6903920,65,-6,3,Office Supplies,Storage,71,71,-18
BN-2012-702658,15,-11,1,Office Supplies,Art,26,26,-11
BN-2012-704979,1193,-704,9,Furniture,Bookcases,1405,1897,-6336
BN-2012-704979,30,-3,4,Office Supplies,Binders,33,33,-12
BN-2012-7073852,522,-78,5,Furniture,Chairs,600,600,-390
BN-2012-7104016,89,-30,7,Office Supplies,Art,119,119,-210
BN-2012-7104016,63,-38,7,Office Supplies,Paper,101,101,-266
BN-2012-7104016,58,-30,2,Office Supplies,Storage,88,88,-60
BN-2012-7104016,87,-78,6,Office Supplies,Supplies,165,165,-468
BN-2012-7104016,183,-128,5,Technology,Phones,311,311,-640
BN-2012-7150629,1765,-98,5,Furniture,Bookcases,1863,1863,-490
BN-2012-7150629,190,15,3,Office Supplies,Appliances,175,175,45
BN-2012-716723,220,24,2,Furniture,Furnishings,196,196,48
BN-2012-716723,203,65,4,Office Supplies,Art,138,138,260
BN-2012-716723,758,-62,3,Technology,Copiers,820,820,-186
BN-2012-7168057,32,7,3,Office Supplies,Binders,25,25,21
BN-2012-7203367,59,-1,2,Technology,Machines,60,60,-2
BN-2012-7203367,54,-5,1,Technology,Phones,59,59,-5
BN-2012-720460,1894,-111,7,Technology,Copiers,2005,2005,-777
BN-2012-7217893,43,-25,2,Office Supplies,Appliances,68,68,-50
BN-2012-7217893,46,0,3,Office Supplies,Binders,46,46,0
BN-2012-723325,365,-124,2,Furniture,Bookcases,489,489,-248
BN-2012-7235703,43,-7,5,Office Supplies,Art,50,50,-35
BN-2012-7240284,142,48,7,Office Supplies,Art,59,94,336
BN-2012-7240284,302,6,6,Technology,Machines,296,296,36
BN-2012-7249062,158,-54,5,Furniture,Furnishings,212,212,-270
BN-2012-7258485,25,-6,5,Office Supplies,Fasteners,31,31,-30
BN-2012-7268418,255,20,2,Office Supplies,Storage,235,235,40
BN-2012-7331747,2071,-621,9,Furniture,Chairs,2692,2692,-5589
BN-2012-7331747,39,-27,7,Office Supplies,Fasteners,66,66,-189
BN-2012-7331747,11,-7,2,Office Supplies,Labels,18,18,-14
BN-2012-7331747,316,-158,3,Office Supplies,Storage,474,474,-474
BN-2012-7331747,366,-241,3,Technology,Copiers,607,607,-723
BN-2012-7331747,81,-45,2,Technology,Phones,126,126,-90
BN-2012-7339265,49,-5,8,Office Supplies,Binders,54,54,-40
BN-2012-7456673,435,87,3,Furniture,Chairs,348,348,261
BN-2012-7456673,2284,0,9,Office Supplies,Appliances,2284,2284,0
BN-2012-7504566,39,-19,3,Office Supplies,Art,58,58,-57
BN-2012-7559738,177,-66,8,Office Supplies,Binders,28,243,-528
BN-2012-7559738,46,-29,5,Office Supplies,Envelopes,75,75,-145
BN-2012-7644341,343,-223,5,Furniture,Chairs,566,566,-1115
BN-2012-7736321,39,-30,2,Office Supplies,Supplies,69,69,-60
BN-2012-7755774,1201,-148,2,Furniture,Tables,1349,1349,-296
BN-2012-7755774,505,45,1,Office Supplies,Appliances,460,460,45
BN-2012-7786585,835,-28,2,Furniture,Chairs,863,863,-56
BN-2012-7860696,762,-8,5,Furniture,Bookcases,770,770,-40
BN-2012-7860696,65,25,6,Office Supplies,Labels,40,40,150
BN-2012-7987412,16,-6,3,Office Supplies,Labels,22,22,-18
BN-2012-8141074,69,-6,2,Technology,Machines,75,75,-12
BN-2012-8185079,119,7,3,Furniture,Furnishings,112,112,21
BN-2012-8185079,137,0,1,Office Supplies,Storage,137,137,0
BN-2012-8200042,30,-17,2,Office Supplies,Paper,47,47,-34
BN-2012-831365,139,14,3,Office Supplies,Paper,125,125,42
BN-2012-831365,134,-31,3,Technology,Phones,165,165,-93
BN-2012-8336784,60,25,5,Office Supplies,Art,35,35,125
BN-2012-834682,49,-21,2,Office Supplies,Art,70,70,-42
BN-2012-834682,86,-29,4,Technology,Accessories,115,115,-116
BN-2012-8351740,9,4,1,Office Supplies,Labels,5,5,4
BN-2012-8351740,61,-14,4,Office Supplies,Storage,75,75,-56
BN-2012-8351740,65,30,2,Office Supplies,Supplies,35,35,60
BN-2012-8357791,98,-5,2,Office Supplies,Storage,103,103,-10
BN-2012-8400051,3,-1,1,Office Supplies,Labels,4,4,-1
BN-2012-8414953,641,-25,16,Office Supplies,Art,346,666,-400
BN-2012-8414953,152,10,9,Office Supplies,Fasteners,142,142,90
BN-2012-8414953,207,-7,4,Office Supplies,Storage,214,214,-28
BN-2012-8414953,127,13,3,Office Supplies,Supplies,114,114,39
BN-2012-8414953,223,5,1,Technology,Accessories,218,218,5
BN-2012-8415709,15,-10,2,Office Supplies,Art,25,25,-20
BN-2012-8433873,264,-127,3,Technology,Phones,391,391,-381
BN-2012-8465204,16,-9,3,Office Supplies,Binders,25,25,-27
BN-2012-8465535,229,-20,2,Office Supplies,Storage,249,249,-40
BN-2012-847015,100,-90,5,Office Supplies,Envelopes,190,190,-450
BN-2012-847015,34,-9,7,Office Supplies,Fasteners,43,43,-63
BN-2012-8498920,56,-1,2,Office Supplies,Storage,57,57,-2
BN-2012-8539408,510,-40,2,Office Supplies,Appliances,550,550,-80
BN-2012-8548299,17,-19,1,Furniture,Furnishings,36,36,-19
BN-2012-8548299,17,-10,2,Office Supplies,Paper,27,27,-20
BN-2012-8602760,211,-73,10,Office Supplies,Art,250,284,-730
BN-2012-8602760,57,-33,4,Office Supplies,Binders,90,90,-132
BN-2012-8602760,37,-28,2,Office Supplies,Envelopes,65,65,-56
BN-2012-8602760,14,-5,2,Office Supplies,Fasteners,19,19,-10
BN-2012-8602760,67,-28,3,Office Supplies,Supplies,95,95,-84
BN-2012-8602760,205,-107,4,Technology,Accessories,312,312,-428
BN-2012-8607495,108,-58,4,Office Supplies,Art,166,166,-232
BN-2012-8610295,84,30,3,Office Supplies,Paper,54,54,90
BN-2012-8662125,190,95,7,Office Supplies,Art,95,95,665
BN-2012-8662125,245,88,5,Office Supplies,Binders,157,157,440
BN-2012-8662125,47,4,1,Office Supplies,Supplies,43,43,4
BN-2012-8662125,364,142,2,Technology,Phones,222,222,284
BN-2012-8675695,133,-4,1,Furniture,Bookcases,137,137,-4
BN-2012-8691355,341,-341,5,Technology,Phones,682,682,-1705
BN-2012-8726185,549,-428,3,Furniture,Bookcases,977,977,-1284
BN-2012-8726185,33,-17,6,Office Supplies,Art,50,50,-102
BN-2012-8726185,28,-8,3,Office Supplies,Paper,36,36,-24
BN-2012-873448,223,-112,3,Furniture,Bookcases,335,335,-336
BN-2012-873448,20,-4,3,Office Supplies,Fasteners,24,24,-12
BN-2012-873448,520,-396,7,Technology,Copiers,916,916,-2772
BN-2012-8740514,112,-94,3,Technology,Machines,206,206,-282
BN-2012-8746032,147,42,3,Office Supplies,Art,105,105,126
BN-2012-8746032,30,5,1,Office Supplies,Binders,25,25,5
BN-2012-8746032,70,4,3,Office Supplies,Envelopes,66,66,12
BN-2012-8746032,127,-7,7,Office Supplies,Storage,134,134,-49
BN-2012-8846248,122,-59,2,Technology,Copiers,181,181,-118
BN-2012-8846248,100,-42,3,Technology,Phones,142,142,-126
BN-2012-8860011,278,72,6,Office Supplies,Art,206,206,432
BN-2012-8860011,6,3,1,Office Supplies,Labels,3,3,3
BN-2012-8860011,1075,516,3,Technology,Copiers,559,559,1548
BN-2012-8886681,774,-743,3,Furniture,Tables,1517,1517,-2229
BN-2012-8886681,45,8,4,Office Supplies,Labels,37,37,32
BN-2012-8901180,16,-8,3,Office Supplies,Binders,24,24,-24
BN-2012-8901180,73,-51,2,Technology,Phones,124,124,-102
BN-2012-8901808,38,-8,4,Office Supplies,Art,46,46,-32
BN-2012-8901808,251,-146,10,Office Supplies,Binders,397,397,-1460
BN-2012-8981515,27,-18,2,Office Supplies,Art,45,45,-36
BN-2012-9003210,29,-22,2,Office Supplies,Art,51,51,-44
BN-2012-9077460,27,-2,2,Office Supplies,Supplies,29,29,-4
BN-2012-9118529,14,-10,2,Office Supplies,Fasteners,24,24,-20
BN-2012-9196475,103,-64,4,Office Supplies,Art,167,167,-256
BN-2012-9201500,148,0,3,Office Supplies,Storage,148,148,0
BN-2012-9267764,48,-30,2,Office Supplies,Art,78,78,-60
BN-2012-9267764,15,-7,2,Office Supplies,Binders,22,22,-14
BN-2012-9279077,95,0,7,Office Supplies,Art,95,95,0
BN-2012-9279077,71,-71,5,Office Supplies,Binders,142,142,-355
BN-2012-9322615,72,10,3,Office Supplies,Supplies,62,62,30
BN-2012-9322615,1136,-54,7,Technology,Copiers,1190,1190,-378
BN-2012-9454335,136,52,3,Technology,Accessories,84,84,156
BN-2012-9454335,332,-22,3,Technology,Machines,354,354,-66
BN-2012-9505368,1393,-140,11,Office Supplies,Storage,1533,1533,-1540
BN-2012-9605116,17,-5,3,Office Supplies,Binders,22,22,-15
BN-2012-9605116,31,-17,2,Office Supplies,Paper,48,48,-34
BN-2012-9606343,11,-7,2,Office Supplies,Fasteners,18,18,-14
BN-2012-9614623,308,-240,2,Technology,Machines,548,548,-480
BN-2012-9634659,122,-29,1,Office Supplies,Storage,151,151,-29
BN-2012-9713338,244,12,5,Office Supplies,Art,17,232,60
BN-2012-9713338,161,-56,2,Office Supplies,Storage,217,217,-112
BN-2012-9713338,58,-7,2,Technology,Machines,65,65,-14
BN-2012-9766110,1027,-719,7,Furniture,Bookcases,1746,1746,-5033
BN-2012-9766110,34,-14,5,Office Supplies,Binders,48,48,-70
BN-2012-9766110,7,-4,1,Office Supplies,Fasteners,11,11,-4
BN-2012-9766110,8,-9,2,Office Supplies,Storage,17,17,-18
BN-2012-9766110,84,-75,2,Technology,Machines,159,159,-150
BN-2012-9784298,124,-15,1,Technology,Copiers,139,139,-15
BN-2012-9869476,757,68,2,Technology,Copiers,689,689,136
BN-2012-9869476,211,-49,2,Technology,Phones,260,260,-98
BN-2012-9894081,494,-55,4,Office Supplies,Storage,549,549,-220
BN-2012-9955525,174,10,9,Office Supplies,Envelopes,164,164,90
BN-2012-9976090,27,-5,1,Furniture,Chairs,32,32,-5
BN-2012-9976090,37,-4,5,Office Supplies,Binders,41,41,-20
BN-2012-9976090,73,-51,2,Technology,Phones,124,124,-102
BN-2013-1094038,37,-6,1,Office Supplies,Storage,43,43,-6
BN-2013-1199196,20,-4,3,Office Supplies,Binders,24,24,-12
BN-2013-1199196,35,-33,2,Office Supplies,Envelopes,68,68,-66
BN-2013-1199196,482,-145,3,Technology,Copiers,627,627,-435
BN-2013-1210001,94,-19,3,Office Supplies,Appliances,113,113,-57
BN-2013-1262066,220,-202,1,Furniture,Bookcases,422,422,-202
BN-2013-1262066,41,13,2,Furniture,Furnishings,28,28,26
BN-2013-1262066,19,-9,9,Office Supplies,Labels,28,28,-81
BN-2013-1315378,471,-462,3,Technology,Machines,933,933,-1386
BN-2013-132912,188,-18,2,Technology,Machines,206,206,-36
BN-2013-1331129,20,0,2,Office Supplies,Storage,20,20,0
BN-2013-1382907,127,-56,4,Furniture,Chairs,183,183,-224
BN-2013-1382907,273,-224,4,Technology,Phones,497,497,-896
BN-2013-1501902,251,-63,3,Technology,Phones,314,314,-189
BN-2013-1505908,215,-120,3,Furniture,Bookcases,335,335,-360
BN-2013-1505908,143,-26,5,Technology,Accessories,169,169,-130
BN-2013-1607455,20,-1,5,Office Supplies,Binders,21,21,-5
BN-2013-1620263,15,-2,3,Office Supplies,Labels,17,17,-6
BN-2013-1620263,85,-15,3,Office Supplies,Storage,100,100,-45
BN-2013-1628008,1322,-317,6,Furniture,Bookcases,1639,1639,-1902
BN-2013-1628008,143,-106,7,Furniture,Furnishings,249,249,-742
BN-2013-1628008,773,-681,10,Technology,Phones,1454,1454,-6810
BN-2013-1634253,1615,-162,6,Office Supplies,Appliances,1777,1777,-972
BN-2013-1634253,36,-22,3,Office Supplies,Art,58,58,-66
BN-2013-1634253,23,-21,7,Office Supplies,Labels,44,44,-147
BN-2013-1667330,311,-644,2,Furniture,Tables,955,955,-1288
BN-2013-1829303,104,-136,2,Furniture,Chairs,240,240,-272
BN-2013-1962674,159,0,1,Furniture,Chairs,159,159,0
BN-2013-1962674,139,6,4,Office Supplies,Storage,90,133,24
BN-2013-1963418,6,2,1,Office Supplies,Binders,4,4,2
BN-2013-1963418,22,10,2,Office Supplies,Labels,12,12,20
BN-2013-1977946,543,-130,2,Office Supplies,Appliances,673,673,-260
BN-2013-1977946,636,-153,6,Office Supplies,Storage,789,789,-918
BN-2013-2008783,250,97,2,Furniture,Bookcases,153,153,194
BN-2013-2008783,26,11,1,Office Supplies,Art,15,15,11
BN-2013-2008783,1021,178,9,Office Supplies,Storage,127,843,1602
BN-2013-2045874,404,99,3,Furniture,Chairs,305,305,297
BN-2013-2045874,246,39,5,Office Supplies,Paper,207,207,195
BN-2013-2045874,156,47,3,Office Supplies,Storage,109,109,141
BN-2013-2045874,299,-25,2,Technology,Machines,324,324,-50
BN-2013-2085562,137,-28,2,Office Supplies,Storage,165,165,-56
BN-2013-2144250,132,54,5,Office Supplies,Art,78,78,270
BN-2013-2153787,72,-24,9,Furniture,Furnishings,96,96,-216
BN-2013-2153787,20,-1,3,Office Supplies,Labels,21,21,-3
BN-2013-2157928,21,-13,2,Office Supplies,Storage,34,34,-26
BN-2013-236928,401,45,3,Furniture,Bookcases,356,356,135
BN-2013-236928,49,5,1,Office Supplies,Envelopes,44,44,5
BN-2013-2401973,36,-3,3,Office Supplies,Art,39,39,-9
BN-2013-2401973,31,6,6,Office Supplies,Binders,25,25,36
BN-2013-2401973,7,0,1,Office Supplies,Envelopes,7,7,0
BN-2013-2401973,1607,125,9,Office Supplies,Storage,1482,1482,1125
BN-2013-2401973,39,10,1,Technology,Accessories,29,29,10
BN-2013-2413609,318,9,7,Office Supplies,Art,309,309,63
BN-2013-2477715,94,-19,3,Office Supplies,Appliances,113,113,-57
BN-2013-2488199,383,-5,3,Technology,Copiers,388,388,-15
BN-2013-2505357,148,54,2,Furniture,Chairs,94,94,108
BN-2013-2514877,43,-2,7,Office Supplies,Labels,45,45,-14
BN-2013-2516957,121,-1,1,Office Supplies,Storage,122,122,-1
BN-2013-2545155,511,-450,6,Furniture,Bookcases,961,961,-2700
BN-2013-2545155,2571,-2211,11,Furniture,Chairs,4782,4782,-24321
BN-2013-2588194,27,-23,3,Office Supplies,Art,50,50,-69
BN-2013-2588194,14,-11,2,Office Supplies,Fasteners,25,25,-22
BN-2013-2588194,468,-281,3,Technology,Machines,749,749,-843
BN-2013-2606069,335,-30,5,Technology,Phones,365,365,-150
BN-2013-2633333,18,-11,4,Office Supplies,Binders,29,29,-44
BN-2013-2658555,104,-5,7,Office Supplies,Storage,109,109,-35
BN-2013-2677709,14,0,1,Office Supplies,Envelopes,14,14,0
BN-2013-2677709,14,-4,2,Office Supplies,Fasteners,18,18,-8
BN-2013-2677709,89,-67,6,Office Supplies,Supplies,156,156,-402
BN-2013-2678087,396,-317,4,Office Supplies,Storage,713,713,-1268
BN-2013-2678087,1278,-358,4,Technology,Phones,1636,1636,-1432
BN-2013-2697575,19,-1,2,Office Supplies,Fasteners,20,20,-2
BN-2013-2717861,139,-20,5,Office Supplies,Appliances,159,159,-100
BN-2013-2717861,53,-33,2,Office Supplies,Art,86,86,-66
BN-2013-2717861,103,-51,12,Office Supplies,Binders,123,154,-612
BN-2013-2717861,50,-45,5,Office Supplies,Storage,95,95,-225
BN-2013-2717861,191,-114,1,Technology,Copiers,305,305,-114
BN-2013-2735217,88,32,2,Furniture,Furnishings,56,56,64
BN-2013-2735217,1291,-40,4,Furniture,Tables,1331,1331,-160
BN-2013-2755077,50,1,1,Office Supplies,Binders,49,49,1
BN-2013-2755077,83,21,3,Office Supplies,Paper,62,62,63
BN-2013-2755077,448,-10,8,Office Supplies,Storage,458,458,-80
BN-2013-2755077,5726,-445,10,Technology,Phones,6171,6171,-4450
BN-2013-2815827,347,-35,3,Office Supplies,Storage,382,382,-105
BN-2013-2819464,28,-1,3,Office Supplies,Envelopes,29,29,-3
BN-2013-2852434,237,-119,2,Office Supplies,Storage,356,356,-238
BN-2013-2943018,721,84,5,Furniture,Bookcases,249,637,420
BN-2013-2943018,94,2,4,Office Supplies,Art,92,92,8
BN-2013-2943018,286,-7,2,Technology,Phones,293,293,-14
BN-2013-2967589,129,17,1,Furniture,Bookcases,112,112,17
BN-2013-2967589,19,6,2,Office Supplies,Labels,5,13,12
BN-2013-2967589,40,13,3,Office Supplies,Paper,27,27,39
BN-2013-2967589,240,107,5,Office Supplies,Storage,133,133,535
BN-2013-2967589,2571,977,4,Technology,Phones,1594,1594,3908
BN-2013-2970866,33,10,3,Office Supplies,Binders,23,23,30
BN-2013-2970866,96,-30,2,Technology,Phones,126,126,-60
BN-2013-299612,260,-109,3,Technology,Phones,369,369,-327
BN-2013-3010775,49,-20,3,Office Supplies,Appliances,69,69,-60
BN-2013-3010775,124,-70,5,Office Supplies,Art,180,194,-350
BN-2013-3010775,73,-31,5,Office Supplies,Binders,104,104,-155
BN-2013-3010775,32,-31,5,Office Supplies,Fasteners,63,63,-155
BN-2013-3010775,678,-813,3,Technology,Phones,1491,1491,-2439
BN-2013-3013518,95,-114,5,Furniture,Chairs,209,209,-570
BN-2013-3136771,16,-15,2,Office Supplies,Art,31,31,-30
BN-2013-3136771,15,-6,2,Office Supplies,Fasteners,21,21,-12
BN-2013-3157910,84,-76,2,Furniture,Chairs,160,160,-152
BN-2013-3206993,195,-190,7,Furniture,Chairs,385,385,-1330
BN-2013-3222447,941,-203,3,Furniture,Tables,1144,1144,-609
BN-2013-3241235,425,-99,5,Office Supplies,Storage,524,524,-495
BN-2013-333027,213,-144,3,Furniture,Chairs,357,357,-432
BN-2013-3350047,1554,730,6,Technology,Accessories,824,824,4380
BN-2013-3350047,303,10,5,Technology,Phones,74,293,50
BN-2013-3382975,104,16,2,Office Supplies,Art,88,88,32
BN-2013-3382975,2157,-216,18,Office Supplies,Storage,975,2373,-3888
BN-2013-3382975,517,72,5,Technology,Accessories,445,445,360
BN-2013-3395469,81,-81,3,Office Supplies,Art,162,162,-243
BN-2013-3395469,24,-23,8,Office Supplies,Binders,47,47,-184
BN-2013-3395469,250,-120,3,Technology,Phones,370,370,-360
BN-2013-3470282,33,-12,5,Office Supplies,Art,45,45,-60
BN-2013-3470282,14,0,4,Office Supplies,Binders,14,14,0
BN-2013-3470282,15,-9,1,Office Supplies,Supplies,24,24,-9
BN-2013-3574663,18,-18,4,Office Supplies,Labels,36,36,-72
BN-2013-3574663,136,-93,8,Office Supplies,Supplies,229,229,-744
BN-2013-3585315,39,-25,7,Office Supplies,Labels,64,64,-175
BN-2013-3585315,49,-17,2,Office Supplies,Storage,66,66,-34
BN-2013-3586585,510,-10,6,Technology,Copiers,520,520,-60
BN-2013-3695391,2892,1189,7,Furniture,Chairs,1703,1703,8323
BN-2013-3695391,464,-16,4,Office Supplies,Storage,480,480,-64
BN-2013-3695391,66,4,3,Office Supplies,Supplies,62,62,12
BN-2013-3695391,316,123,3,Technology,Copiers,193,193,369
BN-2013-3731561,93,-62,7,Furniture,Furnishings,155,155,-434
BN-2013-3731561,172,34,6,Office Supplies,Supplies,138,138,204
BN-2013-3793462,166,-140,12,Office Supplies,Art,306,306,-1680
BN-2013-3793462,90,-75,4,Technology,Machines,165,165,-300
BN-2013-3803426,70,-27,2,Furniture,Furnishings,97,97,-54
BN-2013-3803426,81,37,3,Office Supplies,Art,44,44,111
BN-2013-3817334,116,-157,5,Furniture,Furnishings,273,273,-785
BN-2013-3849014,176,-151,3,Technology,Machines,327,327,-453
BN-2013-3917752,153,-52,4,Office Supplies,Appliances,205,205,-208
BN-2013-3917752,77,-51,3,Office Supplies,Art,128,128,-153
BN-2013-3917752,75,-44,3,Office Supplies,Binders,119,119,-132
BN-2013-3933784,107,-47,8,Office Supplies,Art,154,154,-376
BN-2013-3933784,21,-5,5,Office Supplies,Fasteners,26,26,-25
BN-2013-397330,598,-49,4,Technology,Machines,647,647,-196
BN-2013-407737,87,-16,6,Office Supplies,Art,103,103,-96
BN-2013-407737,163,-88,5,Technology,Phones,251,251,-440
BN-2013-4083449,44,-29,3,Office Supplies,Binders,73,73,-87
BN-2013-4141546,154,45,3,Furniture,Furnishings,109,109,135
BN-2013-4141546,1333,548,11,Office Supplies,Storage,785,785,6028
BN-2013-4141546,1331,-104,12,Technology,Phones,1435,1435,-1248
BN-2013-4285479,53,-2,3,Office Supplies,Storage,55,55,-6
BN-2013-4285479,598,299,5,Technology,Copiers,299,299,1495
BN-2013-4296083,92,-15,4,Office Supplies,Envelopes,107,107,-60
BN-2013-4341327,19,-1,2,Office Supplies,Fasteners,20,20,-2
BN-2013-4370174,225,0,6,Furniture,Furnishings,225,225,0
BN-2013-4388015,9,-9,3,Office Supplies,Binders,18,18,-27
BN-2013-4388015,110,-18,3,Technology,Phones,128,128,-54
BN-2013-441704,581,-198,3,Furniture,Bookcases,779,779,-594
BN-2013-441704,369,78,9,Furniture,Furnishings,126,291,702
BN-2013-441704,148,-47,7,Office Supplies,Art,178,195,-329
BN-2013-441704,12,-11,2,Office Supplies,Binders,23,23,-22
BN-2013-441704,72,-58,2,Technology,Accessories,130,130,-116
BN-2013-4445925,24,-23,2,Office Supplies,Storage,47,47,-46
BN-2013-4461629,112,-69,5,Office Supplies,Art,181,181,-345
BN-2013-4461629,12,-6,2,Office Supplies,Binders,18,18,-12
BN-2013-4478549,75,-5,3,Office Supplies,Envelopes,80,80,-15
BN-2013-4615508,406,-10,2,Technology,Copiers,416,416,-20
BN-2013-4615508,534,119,7,Technology,Phones,415,415,833
BN-2013-4799461,297,-101,4,Furniture,Bookcases,110,398,-404
BN-2013-4799461,994,-656,4,Office Supplies,Appliances,1650,1650,-2624
BN-2013-4799461,19,-9,2,Office Supplies,Art,28,28,-18
BN-2013-4799461,55,-40,7,Office Supplies,Fasteners,37,95,-280
BN-2013-4799461,59,-32,6,Office Supplies,Paper,62,91,-192
BN-2013-4811431,28,-20,1,Furniture,Chairs,48,48,-20
BN-2013-4811431,40,-47,4,Furniture,Furnishings,87,87,-188
BN-2013-4811431,163,-39,5,Technology,Phones,202,202,-195
BN-2013-48132,735,-184,2,Furniture,Chairs,919,919,-368
BN-2013-4841174,428,133,7,Office Supplies,Storage,295,295,931
BN-2013-4893247,28,-10,2,Office Supplies,Binders,38,38,-20
BN-2013-4893247,79,-36,3,Office Supplies,Paper,115,115,-108
BN-2013-4893247,529,-254,6,Technology,Phones,783,783,-1524
BN-2013-4955166,166,-22,3,Technology,Phones,188,188,-66
BN-2013-5022236,56,-42,10,Office Supplies,Binders,89,98,-420
BN-2013-5022236,14,-10,1,Office Supplies,Paper,24,24,-10
BN-2013-5031652,1508,-981,8,Technology,Machines,2489,2489,-7848
BN-2013-5104816,47,-19,4,Office Supplies,Storage,66,66,-76
BN-2013-5107486,191,-187,3,Office Supplies,Storage,378,378,-561
BN-2013-5107486,228,-114,3,Technology,Phones,342,342,-342
BN-2013-5166779,46,-40,7,Office Supplies,Binders,86,86,-280
BN-2013-5190964,122,39,10,Office Supplies,Art,47,83,390
BN-2013-5190964,133,27,9,Office Supplies,Envelopes,76,106,243
BN-2013-5190964,49,3,1,Office Supplies,Supplies,46,46,3
BN-2013-5190964,378,185,1,Technology,Copiers,193,193,185
BN-2013-528810,516,-396,2,Furniture,Tables,912,912,-792
BN-2013-5329355,13,-13,3,Office Supplies,Labels,26,26,-39
BN-2013-5457641,43,5,1,Furniture,Furnishings,38,38,5
BN-2013-5457641,15,-6,3,Office Supplies,Labels,21,21,-18
BN-2013-5478479,67,-77,3,Furniture,Chairs,144,144,-231
BN-2013-5550345,73,-33,3,Furniture,Furnishings,106,106,-99
BN-2013-5560836,69,-65,2,Office Supplies,Appliances,134,134,-130
BN-2013-5717739,356,-178,3,Office Supplies,Storage,534,534,-534
BN-2013-5807388,339,-217,4,Technology,Phones,556,556,-868
BN-2013-5809752,816,363,2,Furniture,Tables,453,453,726
BN-2013-5809752,168,-4,3,Office Supplies,Storage,172,172,-12
BN-2013-583958,1096,-422,5,Furniture,Tables,1518,1518,-2110
BN-2013-5868311,75,-2,5,Furniture,Furnishings,51,77,-10
BN-2013-5868311,259,-166,10,Office Supplies,Binders,425,425,-1660
BN-2013-5879462,233,35,5,Office Supplies,Art,198,198,175
BN-2013-5879462,45,6,3,Office Supplies,Binders,39,39,18
BN-2013-5895980,18,-6,3,Office Supplies,Labels,24,24,-18
BN-2013-5896563,1026,431,4,Technology,Accessories,595,595,1724
BN-2013-5978762,5,-2,2,Office Supplies,Labels,7,7,-4
BN-2013-5978762,49,-17,2,Office Supplies,Storage,66,66,-34
BN-2013-5978762,896,-36,5,Technology,Copiers,932,932,-180
BN-2013-5989900,252,-157,11,Office Supplies,Art,384,409,-1727
BN-2013-6003171,96,-8,3,Furniture,Chairs,104,104,-24
BN-2013-6003171,24,-8,3,Furniture,Furnishings,32,32,-24
BN-2013-6003171,101,-89,4,Office Supplies,Binders,190,190,-356
BN-2013-6003171,30,-16,3,Office Supplies,Envelopes,46,46,-48
BN-2013-6003171,224,-14,4,Technology,Accessories,238,238,-56
BN-2013-6003171,108,-13,3,Technology,Phones,121,121,-39
BN-2013-603818,21,9,2,Office Supplies,Fasteners,12,12,18
BN-2013-6039695,27,-10,3,Furniture,Furnishings,37,37,-30
BN-2013-6076814,63,-1,4,Office Supplies,Art,64,64,-4
BN-2013-6111017,2138,-2,18,Office Supplies,Storage,631,2140,-36
BN-2013-6154570,104,-7,2,Office Supplies,Appliances,111,111,-14
BN-2013-6154570,742,59,3,Technology,Accessories,683,683,177
BN-2013-6158270,714,-309,7,Technology,Machines,1023,1023,-2163
BN-2013-6206755,573,0,2,Technology,Copiers,573,573,0
BN-2013-6314104,41,-11,6,Office Supplies,Binders,52,52,-66
BN-2013-6379006,28,-8,6,Office Supplies,Labels,36,36,-48
BN-2013-6417134,91,-14,3,Furniture,Furnishings,105,105,-42
BN-2013-6496394,296,-243,3,Office Supplies,Storage,539,539,-729
BN-2013-6496394,23,-1,2,Office Supplies,Supplies,24,24,-2
BN-2013-6506387,70,-31,9,Office Supplies,Binders,101,101,-279
BN-2013-6509529,1460,336,4,Furniture,Bookcases,1124,1124,1344
BN-2013-6509529,249,112,3,Office Supplies,Appliances,137,137,336
BN-2013-6509529,22,8,3,Office Supplies,Binders,14,14,24
BN-2013-6509529,46,3,4,Office Supplies,Labels,43,43,12
BN-2013-6544742,139,-67,6,Office Supplies,Art,206,206,-402
BN-2013-6614277,192,-108,9,Office Supplies,Supplies,300,300,-972
BN-2013-6637489,271,-30,1,Technology,Copiers,301,301,-30
BN-2013-6654640,82,-18,4,Office Supplies,Envelopes,100,100,-72
BN-2013-6699352,653,-457,3,Furniture,Bookcases,1110,1110,-1371
BN-2013-6699352,109,-18,3,Technology,Accessories,127,127,-54
BN-2013-6770556,682,327,4,Furniture,Chairs,355,355,1308
BN-2013-6837899,165,57,5,Office Supplies,Appliances,108,108,285
BN-2013-6837899,49,5,1,Office Supplies,Binders,44,44,5
BN-2013-6837899,31,13,3,Office Supplies,Fasteners,18,18,39
BN-2013-6837899,41,10,4,Office Supplies,Supplies,31,31,40
BN-2013-6854769,122,-7,3,Furniture,Chairs,129,129,-21
BN-2013-6882863,59,25,2,Office Supplies,Paper,34,34,50
BN-2013-6882863,247,-27,2,Office Supplies,Storage,274,274,-54
BN-2013-6882863,263,-28,2,Technology,Phones,291,291,-56
BN-2013-6883995,241,-27,3,Furniture,Chairs,268,268,-81
BN-2013-6883995,460,0,4,Technology,Accessories,460,460,0
BN-2013-6883995,1249,88,5,Technology,Copiers,1161,1161,440
BN-2013-6886875,22,-11,5,Office Supplies,Envelopes,33,33,-55
BN-2013-6886875,197,-118,2,Office Supplies,Storage,315,315,-236
BN-2013-6927088,137,45,5,Office Supplies,Envelopes,92,92,225
BN-2013-6927088,313,-26,3,Technology,Copiers,339,339,-78
BN-2013-6936779,73,-49,5,Office Supplies,Storage,122,122,-245
BN-2013-695531,397,-4,5,Furniture,Chairs,401,401,-20
BN-2013-7023709,989,-435,4,Furniture,Tables,1424,1424,-1740
BN-2013-7023709,152,-22,6,Office Supplies,Storage,127,174,-132
BN-2013-7058258,10,-3,2,Office Supplies,Binders,13,13,-6
BN-2013-7058258,291,-205,12,Office Supplies,Storage,32,496,-2460
BN-2013-7163179,920,-276,4,Furniture,Chairs,1196,1196,-1104
BN-2013-7163179,26,-12,3,Office Supplies,Envelopes,38,38,-36
BN-2013-7163179,16,-16,3,Office Supplies,Storage,32,32,-48
BN-2013-7163179,299,-197,7,Technology,Accessories,496,496,-1379
BN-2013-7163306,28,0,3,Office Supplies,Labels,28,28,0
BN-2013-717588,30,-4,2,Office Supplies,Paper,34,34,-8
BN-2013-7214876,467,-26,9,Furniture,Chairs,493,493,-234
BN-2013-7214876,59,7,2,Office Supplies,Paper,52,52,14
BN-2013-7214876,46,8,2,Office Supplies,Storage,38,38,16
BN-2013-7226862,124,-42,5,Office Supplies,Art,166,166,-210
BN-2013-7266864,22,-20,1,Furniture,Chairs,42,42,-20
BN-2013-7296416,220,-141,8,Office Supplies,Art,361,361,-1128
BN-2013-7296416,40,-8,7,Office Supplies,Fasteners,48,48,-56
BN-2013-7296416,11,-9,2,Office Supplies,Storage,20,20,-18
BN-2013-7296416,21,-14,1,Technology,Accessories,35,35,-14
BN-2013-7300795,356,0,2,Office Supplies,Storage,356,356,0
BN-2013-7314107,166,-100,2,Technology,Phones,266,266,-200
BN-2013-7382571,1715,-1630,5,Furniture,Tables,3345,3345,-8150
BN-2013-746561,139,-139,5,Technology,Accessories,278,278,-695
BN-2013-7504800,456,-25,6,Furniture,Chairs,481,481,-150
BN-2013-7517889,37,-9,6,Office Supplies,Storage,46,46,-54
BN-2013-7528066,374,-21,1,Furniture,Bookcases,395,395,-21
BN-2013-7528066,106,33,2,Furniture,Chairs,73,73,66
BN-2013-7528066,63,7,4,Office Supplies,Art,56,56,28
BN-2013-7528066,155,19,9,Office Supplies,Binders,21,136,171
BN-2013-7528066,736,-78,6,Technology,Copiers,814,814,-468
BN-2013-7528066,212,-15,3,Technology,Machines,227,227,-45
BN-2013-7615077,50,-12,5,Office Supplies,Storage,62,62,-60
BN-2013-7694817,46,8,3,Office Supplies,Art,38,38,24
BN-2013-7694817,92,5,6,Office Supplies,Binders,87,87,30
BN-2013-7723216,68,-23,2,Furniture,Furnishings,91,91,-46
BN-2013-7852077,139,-191,2,Furniture,Chairs,330,330,-382
BN-2013-7852077,88,-10,3,Office Supplies,Storage,98,98,-30
BN-2013-7934159,362,-4,3,Office Supplies,Storage,366,366,-12
BN-2013-7936258,875,-68,6,Furniture,Chairs,943,943,-408
BN-2013-7972681,2381,952,5,Furniture,Chairs,1429,1429,4760
BN-2013-7972681,261,31,7,Office Supplies,Envelopes,230,230,217
BN-2013-7972681,382,4,3,Office Supplies,Storage,378,378,12
BN-2013-7972681,605,266,5,Technology,Machines,339,339,1330
BN-2013-7972681,304,64,4,Technology,Phones,240,240,256
BN-2013-8024782,756,-59,14,Office Supplies,Appliances,815,815,-826
BN-2013-804810,54,-33,6,Office Supplies,Paper,87,87,-198
BN-2013-804810,74,-57,6,Office Supplies,Supplies,131,131,-342
BN-2013-80695,28,-1,1,Office Supplies,Storage,29,29,-1
BN-2013-80695,94,21,3,Office Supplies,Supplies,73,73,63
BN-2013-8091921,15,-1,3,Office Supplies,Labels,16,16,-3
BN-2013-8091921,81,-20,3,Office Supplies,Storage,101,101,-60
BN-2013-8115911,1485,-241,4,Furniture,Chairs,1726,1726,-964
BN-2013-8157732,75,-6,9,Office Supplies,Paper,81,81,-54
BN-2013-8187001,34,0,3,Office Supplies,Fasteners,34,34,0
BN-2013-8187001,152,-97,2,Office Supplies,Storage,249,249,-194
BN-2013-8197561,1031,-317,3,Furniture,Tables,1348,1348,-951
BN-2013-8199935,486,-27,4,Furniture,Chairs,513,513,-108
BN-2013-8203726,31,-18,2,Office Supplies,Supplies,49,49,-36
BN-2013-8210403,548,74,4,Furniture,Chairs,253,474,296
BN-2013-8210403,119,50,6,Office Supplies,Art,69,69,300
BN-2013-8210403,121,6,9,Office Supplies,Fasteners,115,115,54
BN-2013-8210403,34,4,3,Office Supplies,Labels,30,30,12
BN-2013-8210403,193,8,4,Office Supplies,Paper,185,185,32
BN-2013-8210403,1527,475,8,Office Supplies,Storage,1052,1052,3800
BN-2013-8210403,795,175,3,Technology,Machines,620,620,525
BN-2013-8210403,1502,225,9,Technology,Phones,1277,1277,2025
BN-2013-8249195,180,-54,2,Furniture,Chairs,234,234,-108
BN-2013-8249195,10,-2,1,Office Supplies,Art,12,12,-2
BN-2013-8249195,257,-129,10,Office Supplies,Binders,386,386,-1290
BN-2013-8249195,65,-36,9,Office Supplies,Fasteners,73,101,-324
BN-2013-8249195,5,-1,1,Office Supplies,Labels,6,6,-1
BN-2013-8249195,889,-677,11,Office Supplies,Storage,962,1566,-7447
BN-2013-8281776,338,-20,7,Office Supplies,Storage,146,358,-140
BN-2013-8281776,527,132,2,Technology,Copiers,395,395,264
BN-2013-833210,74,-10,3,Office Supplies,Binders,84,84,-30
BN-2013-833210,588,-341,4,Technology,Copiers,929,929,-1364
BN-2013-8410367,63,-55,5,Office Supplies,Art,118,118,-275
BN-2013-8410367,99,-51,4,Office Supplies,Storage,150,150,-204
BN-2013-8418057,133,-85,2,Office Supplies,Storage,218,218,-170
BN-2013-8437019,69,11,3,Office Supplies,Envelopes,58,58,33
BN-2013-8437019,348,66,3,Technology,Accessories,282,282,198
BN-2013-8437019,1533,506,5,Technology,Machines,1027,1027,2530
BN-2013-8439557,32,-10,5,Office Supplies,Labels,42,42,-50
BN-2013-8439557,291,-116,5,Technology,Accessories,407,407,-580
BN-2013-8480413,109,36,7,Office Supplies,Art,73,73,252
BN-2013-8480413,280,-6,5,Office Supplies,Storage,286,286,-30
BN-2013-8485680,116,56,5,Office Supplies,Supplies,60,60,280
BN-2013-8516545,43,-5,2,Office Supplies,Storage,48,48,-10
BN-2013-8532201,29,3,1,Office Supplies,Art,26,26,3
BN-2013-8532201,204,-20,2,Technology,Machines,224,224,-40
BN-2013-8558415,182,-22,3,Furniture,Bookcases,204,204,-66
BN-2013-8558415,954,-1558,7,Furniture,Tables,2512,2512,-10906
BN-2013-8558415,195,-47,6,Office Supplies,Appliances,242,242,-282
BN-2013-8819107,54,7,1,Furniture,Chairs,47,47,7
BN-2013-8819107,110,-10,4,Office Supplies,Storage,120,120,-40
BN-2013-8819107,850,323,6,Technology,Accessories,70,527,1938
BN-2013-8844888,1107,-263,3,Furniture,Chairs,1370,1370,-789
BN-2013-8861319,69,-16,2,Office Supplies,Storage,85,85,-32
BN-2013-8861319,2671,534,7,Technology,Copiers,2137,2137,3738
BN-2013-8862051,1020,265,9,Furniture,Furnishings,755,755,2385
BN-2013-8862051,87,-10,2,Office Supplies,Storage,97,97,-20
BN-2013-8862051,94,18,2,Office Supplies,Supplies,76,76,36
BN-2013-8880167,658,-66,3,Furniture,Bookcases,724,724,-198
BN-2013-889802,43,-1,3,Office Supplies,Envelopes,44,44,-3
BN-2013-893797,393,-306,3,Technology,Copiers,699,699,-918
BN-2013-9063982,132,46,4,Office Supplies,Appliances,86,86,184
BN-2013-9063982,792,278,5,Office Supplies,Storage,49,514,1390
BN-2013-9063982,214,18,2,Technology,Phones,196,196,36
BN-2013-9068340,77,-63,3,Office Supplies,Paper,140,140,-189
BN-2013-9068340,76,-64,11,Office Supplies,Supplies,140,140,-704
BN-2013-9076931,166,27,3,Technology,Accessories,139,139,81
BN-2013-9125930,71,-59,1,Furniture,Bookcases,130,130,-59
BN-2013-9125930,39,-24,3,Office Supplies,Paper,63,63,-72
BN-2013-9131358,78,-65,2,Furniture,Chairs,143,143,-130
BN-2013-9140606,304,-18,5,Furniture,Bookcases,322,322,-90
BN-2013-9140606,29,-2,7,Office Supplies,Binders,31,31,-14
BN-2013-9140606,54,-44,4,Technology,Accessories,98,98,-176
BN-2013-9140606,410,-172,6,Technology,Phones,582,582,-1032
BN-2013-9211723,22,3,1,Office Supplies,Paper,19,19,3
BN-2013-9211723,112,-60,3,Office Supplies,Storage,172,172,-180
BN-2013-9278672,118,-78,5,Furniture,Chairs,196,196,-390
BN-2013-9278672,45,-41,1,Office Supplies,Appliances,86,86,-41
BN-2013-9278672,173,-40,10,Office Supplies,Art,48,213,-400
BN-2013-9278672,42,-30,6,Office Supplies,Binders,50,72,-180
BN-2013-9278672,52,-17,8,Office Supplies,Fasteners,69,69,-136
BN-2013-9278672,252,-35,4,Technology,Phones,287,287,-140
BN-2013-9290481,516,-237,6,Furniture,Bookcases,753,753,-1422
BN-2013-9290481,28,-14,5,Office Supplies,Binders,42,42,-70
BN-2013-9290481,46,-39,3,Office Supplies,Storage,85,85,-117
BN-2013-9290481,37,-36,2,Technology,Accessories,73,73,-72
BN-2013-9290481,181,-87,3,Technology,Machines,268,268,-261
BN-2013-931788,70,-28,5,Office Supplies,Paper,98,98,-140
BN-2013-9324340,226,61,5,Office Supplies,Envelopes,165,165,305
BN-2013-9324448,555,11,11,Furniture,Furnishings,544,544,121
BN-2013-9324448,14,5,1,Office Supplies,Labels,9,9,5
BN-2013-9375572,3400,-3060,12,Office Supplies,Appliances,6460,6460,-36720
BN-2013-9407100,373,-4,7,Furniture,Chairs,377,377,-28
BN-2013-9407100,49,23,1,Office Supplies,Art,26,26,23
BN-2013-9407100,116,45,11,Office Supplies,Labels,46,71,495
BN-2013-9407100,334,87,2,Technology,Phones,247,247,174
BN-2013-9441489,73,-7,3,Office Supplies,Storage,80,80,-21
BN-2013-9449552,37,-53,3,Office Supplies,Storage,90,90,-159
BN-2013-9455673,421,-14,1,Furniture,Chairs,435,435,-14
BN-2013-9520844,73,10,9,Office Supplies,Labels,63,63,90
BN-2013-9520844,465,140,4,Technology,Accessories,325,325,560
BN-2013-9520844,468,0,3,Technology,Phones,468,468,0
BN-2013-9616857,14,-1,1,Office Supplies,Storage,15,15,-1
BN-2013-9700722,42,-35,3,Office Supplies,Art,77,77,-105
BN-2013-9700722,38,-29,5,Office Supplies,Binders,67,67,-145
BN-2013-9700722,47,-11,4,Office Supplies,Envelopes,58,58,-44
BN-2013-9700722,152,-3,5,Office Supplies,Storage,155,155,-15
BN-2013-9709500,41,-29,2,Furniture,Chairs,70,70,-58
BN-2013-9867098,8,-6,1,Office Supplies,Storage,14,14,-6
BN-2013-9871283,448,0,2,Technology,Machines,448,448,0
BN-2013-9881069,323,-61,7,Furniture,Chairs,384,384,-427
BN-2013-9881069,155,45,4,Technology,Accessories,110,110,180
BN-2013-9881069,336,37,3,Technology,Phones,299,299,111
BN-2013-9886336,84,-16,6,Furniture,Furnishings,100,100,-96
BN-2013-9886336,31,-29,2,Office Supplies,Storage,60,60,-58
BN-2013-9926490,125,-105,3,Office Supplies,Appliances,230,230,-315
BN-2013-9926490,400,-256,6,Office Supplies,Storage,656,656,-1536
BN-2013-9987561,52,-24,6,Office Supplies,Envelopes,76,76,-144
BN-2013-9987561,26,-2,4,Office Supplies,Labels,28,28,-8
BN-2013-9987561,40,-6,3,Office Supplies,Paper,46,46,-18
BN-2013-9987561,249,-434,2,Technology,Copiers,683,683,-868
BN-2014-1002619,13,-9,2,Office Supplies,Labels,22,22,-18
BN-2014-1002619,23,-3,1,Office Supplies,Supplies,26,26,-3
BN-2014-1068004,49,-31,2,Office Supplies,Art,80,80,-62
BN-2014-1068004,21,-10,4,Office Supplies,Fasteners,31,31,-40
BN-2014-1068004,15,-2,1,Office Supplies,Paper,17,17,-2
BN-2014-1068004,27,-7,5,Office Supplies,Storage,34,34,-35
BN-2014-1068004,633,-633,11,Technology,Accessories,1266,1266,-6963
BN-2014-1166603,45,12,7,Office Supplies,Binders,33,33,84
BN-2014-1166603,64,6,4,Office Supplies,Storage,58,58,24
BN-2014-1221335,21,-6,3,Office Supplies,Fasteners,27,27,-18
BN-2014-1278253,45,-15,2,Furniture,Chairs,60,60,-30
BN-2014-1278253,70,-64,5,Office Supplies,Art,134,134,-320
BN-2014-1278253,122,-66,9,Technology,Accessories,188,188,-594
BN-2014-1317809,2830,-1981,13,Furniture,Bookcases,4811,4811,-25753
BN-2014-1317809,85,-16,5,Office Supplies,Art,50,101,-80
BN-2014-1317809,61,-50,4,Office Supplies,Binders,111,111,-200
BN-2014-1317809,252,-146,7,Office Supplies,Storage,324,398,-1022
BN-2014-1328067,1630,-802,5,Furniture,Tables,2432,2432,-4010
BN-2014-1328067,31,1,2,Office Supplies,Binders,30,30,2
BN-2014-1328067,379,63,2,Office Supplies,Storage,316,316,126
BN-2014-1328067,448,148,2,Technology,Copiers,300,300,296
BN-2014-1458748,89,-4,5,Office Supplies,Storage,93,93,-20
BN-2014-1462193,148,-101,2,Furniture,Bookcases,249,249,-202
BN-2014-1462193,413,-314,9,Furniture,Chairs,727,727,-2826
BN-2014-1468237,559,-19,2,Office Supplies,Appliances,578,578,-38
BN-2014-1468237,148,0,3,Office Supplies,Storage,148,148,0
BN-2014-1468237,976,293,4,Technology,Accessories,683,683,1172
BN-2014-1489324,78,-64,7,Office Supplies,Art,142,142,-448
BN-2014-1489324,632,-316,6,Office Supplies,Storage,948,948,-1896
BN-2014-1493038,239,-162,5,Furniture,Chairs,401,401,-810
BN-2014-1507316,37,-6,1,Office Supplies,Storage,43,43,-6
BN-2014-1507316,28,1,1,Technology,Accessories,27,27,1
BN-2014-1528026,18,1,3,Office Supplies,Binders,17,17,3
BN-2014-1528026,1402,109,11,Office Supplies,Storage,1293,1293,1199
BN-2014-1528026,176,37,6,Technology,Accessories,139,139,222
BN-2014-1528026,276,-21,2,Technology,Phones,297,297,-42
BN-2014-153112,24,-1,4,Office Supplies,Labels,25,25,-4
BN-2014-1551236,257,-252,4,Office Supplies,Storage,509,509,-1008
BN-2014-1557149,60,-12,4,Office Supplies,Binders,72,72,-48
BN-2014-1575343,63,-24,6,Office Supplies,Envelopes,87,87,-144
BN-2014-1655185,40,-33,5,Office Supplies,Binders,73,73,-165
BN-2014-1737730,74,-25,3,Office Supplies,Art,99,99,-75
BN-2014-1772108,175,77,3,Office Supplies,Storage,98,98,231
BN-2014-1799683,818,3,9,Office Supplies,Storage,316,815,27
BN-2014-1926985,313,-13,5,Furniture,Bookcases,326,326,-65
BN-2014-1926985,67,-86,9,Furniture,Furnishings,153,153,-774
BN-2014-1926985,42,-3,1,Technology,Machines,45,45,-3
BN-2014-1952726,30,0,1,Office Supplies,Envelopes,30,30,0
BN-2014-1989454,12,3,1,Office Supplies,Art,9,9,3
BN-2014-2056771,140,-58,4,Furniture,Furnishings,198,198,-232
BN-2014-2088809,44,-34,3,Office Supplies,Art,78,78,-102
BN-2014-2088809,17,-11,3,Office Supplies,Labels,28,28,-33
BN-2014-2088809,556,-209,7,Office Supplies,Storage,765,765,-1463
BN-2014-2088809,40,-12,3,Office Supplies,Supplies,52,52,-36
BN-2014-2088809,229,-41,8,Technology,Accessories,270,270,-328
BN-2014-2098637,1854,433,5,Furniture,Bookcases,1421,1421,2165
BN-2014-2098637,623,-192,3,Furniture,Tables,815,815,-576
BN-2014-2113216,26,-25,3,Office Supplies,Storage,51,51,-75
BN-2014-2116035,45,0,2,Office Supplies,Paper,45,45,0
BN-2014-2116035,192,-146,3,Office Supplies,Storage,338,338,-438
BN-2014-2153442,41,6,3,Office Supplies,Binders,24,35,18
BN-2014-2153442,595,292,3,Office Supplies,Storage,303,303,876
BN-2014-2221750,25,-11,1,Office Supplies,Art,36,36,-11
BN-2014-2221750,30,-6,2,Office Supplies,Binders,36,36,-12
BN-2014-2221750,33,-10,6,Office Supplies,Fasteners,43,43,-60
BN-2014-2221750,21,-17,3,Office Supplies,Supplies,38,38,-51
BN-2014-2257467,335,-22,7,Furniture,Chairs,357,357,-154
BN-2014-2274076,767,-353,5,Office Supplies,Appliances,1120,1120,-1765
BN-2014-2274076,45,-28,2,Office Supplies,Art,73,73,-56
BN-2014-2274076,25,-1,4,Office Supplies,Envelopes,26,26,-4
BN-2014-2274076,584,-444,7,Technology,Copiers,1028,1028,-3108
BN-2014-2290642,60,-49,8,Office Supplies,Binders,109,109,-392
BN-2014-2290642,30,-25,2,Office Supplies,Paper,55,55,-50
BN-2014-2311123,1361,-980,3,Furniture,Tables,2341,2341,-2940
BN-2014-2311123,137,-41,3,Technology,Phones,178,178,-123
BN-2014-2369995,724,-447,4,Technology,Machines,1171,1171,-1788
BN-2014-2393314,1042,160,11,Office Supplies,Storage,115,882,1760
BN-2014-2423414,117,17,6,Office Supplies,Envelopes,100,100,102
BN-2014-2423414,2582,-304,10,Technology,Copiers,1114,2886,-3040
BN-2014-2450854,69,-67,4,Office Supplies,Envelopes,136,136,-268
BN-2014-2450854,59,-46,7,Office Supplies,Paper,105,105,-322
BN-2014-2460712,38,-6,2,Furniture,Furnishings,44,44,-12
BN-2014-2460712,50,-17,2,Office Supplies,Art,67,67,-34
BN-2014-2460712,47,-20,2,Office Supplies,Envelopes,67,67,-40
BN-2014-2460712,61,-25,4,Technology,Accessories,86,86,-100
BN-2014-2462392,224,-143,3,Furniture,Chairs,367,367,-429
BN-2014-2516060,24,-14,2,Office Supplies,Storage,38,38,-28
BN-2014-2516060,209,-21,2,Technology,Machines,230,230,-42
BN-2014-2531975,85,-9,4,Office Supplies,Storage,94,94,-36
BN-2014-2534492,248,-70,3,Furniture,Chairs,318,318,-210
BN-2014-2557638,674,293,5,Furniture,Bookcases,195,381,1465
BN-2014-2557638,287,-280,12,Furniture,Chairs,567,567,-3360
BN-2014-2557638,110,35,1,Furniture,Furnishings,75,75,35
BN-2014-2557638,148,59,3,Office Supplies,Binders,89,89,177
BN-2014-2557638,1183,106,4,Technology,Copiers,1077,1077,424
BN-2014-2570912,355,-4,2,Office Supplies,Storage,359,359,-8
BN-2014-2616164,1582,-443,6,Office Supplies,Appliances,2025,2025,-2658
BN-2014-2645644,48,-22,2,Office Supplies,Storage,70,70,-44
BN-2014-2653916,29,-3,3,Office Supplies,Storage,32,32,-9
BN-2014-2658770,9,-9,2,Office Supplies,Envelopes,18,18,-18
BN-2014-2658770,74,-59,2,Technology,Accessories,133,133,-118
BN-2014-2717006,299,-28,3,Technology,Machines,327,327,-84
BN-2014-2777881,139,14,3,Office Supplies,Art,125,125,42
BN-2014-2777881,220,-19,2,Office Supplies,Storage,239,239,-38
BN-2014-277851,26,0,2,Office Supplies,Envelopes,26,26,0
BN-2014-277851,24,-24,2,Office Supplies,Storage,48,48,-48
BN-2014-2791040,58,-52,3,Furniture,Chairs,110,110,-156
BN-2014-2791040,119,43,5,Office Supplies,Paper,76,76,215
BN-2014-2791040,765,-153,2,Technology,Phones,918,918,-306
BN-2014-2854953,27,4,3,Office Supplies,Labels,23,23,12
BN-2014-2854953,98,-5,2,Office Supplies,Storage,103,103,-10
BN-2014-2863458,1316,-527,7,Technology,Machines,1843,1843,-3689
BN-2014-291873,263,-31,9,Technology,Machines,294,294,-279
BN-2014-2942497,142,-90,4,Office Supplies,Storage,40,232,-360
BN-2014-2952495,2188,1050,5,Furniture,Bookcases,1138,1138,5250
BN-2014-2952495,328,-15,3,Technology,Machines,343,343,-45
BN-2014-2952495,418,70,7,Technology,Phones,348,348,490
BN-2014-2971842,20,-9,6,Office Supplies,Binders,29,29,-54
BN-2014-2971842,322,-193,5,Technology,Copiers,515,515,-965
BN-2014-2999624,8,-2,1,Office Supplies,Art,10,10,-2
BN-2014-3007442,98,9,2,Furniture,Furnishings,89,89,18
BN-2014-3007442,3151,-35,7,Office Supplies,Appliances,3186,3186,-245
BN-2014-3007442,429,64,13,Office Supplies,Art,38,365,832
BN-2014-3007442,137,27,11,Office Supplies,Binders,91,110,297
BN-2014-3007442,46,14,5,Office Supplies,Labels,32,32,70
BN-2014-301235,34,-11,5,Office Supplies,Paper,45,45,-55
BN-2014-3013563,933,-768,8,Furniture,Bookcases,480,1701,-6144
BN-2014-3013563,29,-24,4,Office Supplies,Fasteners,53,53,-96
BN-2014-3013563,17,-13,4,Office Supplies,Labels,30,30,-52
BN-2014-3037532,643,-45,2,Technology,Copiers,688,688,-90
BN-2014-3043420,465,-33,4,Technology,Phones,498,498,-132
BN-2014-3084273,593,213,4,Furniture,Bookcases,380,380,852
BN-2014-3084273,134,-34,2,Furniture,Chairs,168,168,-68
BN-2014-3084273,1709,564,3,Office Supplies,Appliances,1145,1145,1692
BN-2014-3084273,27,4,2,Office Supplies,Storage,23,23,8
BN-2014-3085945,47,-3,2,Office Supplies,Art,50,50,-6
BN-2014-3094583,80,-19,5,Office Supplies,Art,99,99,-95
BN-2014-3094583,321,-315,5,Office Supplies,Storage,636,636,-1575
BN-2014-3100971,257,-3,2,Furniture,Bookcases,260,260,-6
BN-2014-3140940,37,-53,3,Office Supplies,Storage,90,90,-159
BN-2014-319061,93,-65,4,Office Supplies,Art,158,158,-260
BN-2014-319061,28,-1,6,Office Supplies,Labels,19,29,-6
BN-2014-319061,319,-312,5,Office Supplies,Storage,631,631,-1560
BN-2014-319061,262,-215,2,Technology,Copiers,477,477,-430
BN-2014-3197989,30,-23,2,Office Supplies,Storage,53,53,-46
BN-2014-3198729,77,-43,8,Office Supplies,Art,120,120,-344
BN-2014-3198729,72,-46,7,Office Supplies,Envelopes,118,118,-322
BN-2014-3198729,41,-14,5,Office Supplies,Fasteners,55,55,-70
BN-2014-3227902,341,-85,6,Office Supplies,Appliances,426,426,-510
BN-2014-3227902,261,53,12,Office Supplies,Paper,76,208,636
BN-2014-3227902,620,82,6,Technology,Accessories,538,538,492
BN-2014-323564,47,-114,5,Furniture,Furnishings,161,161,-570
BN-2014-3332467,27,-20,2,Office Supplies,Binders,47,47,-40
BN-2014-3332467,65,-52,3,Technology,Accessories,117,117,-156
BN-2014-3358594,62,-56,5,Office Supplies,Envelopes,118,118,-280
BN-2014-3359053,33,-27,1,Furniture,Chairs,60,60,-27
BN-2014-3375705,8,-2,2,Office Supplies,Binders,10,10,-4
BN-2014-3375705,735,-235,6,Technology,Copiers,970,970,-1410
BN-2014-3382775,76,27,5,Office Supplies,Art,49,49,135
BN-2014-3382775,91,15,6,Office Supplies,Paper,76,76,90
BN-2014-3416372,1361,197,9,Furniture,Bookcases,1164,1164,1773
BN-2014-3416372,761,266,9,Technology,Machines,495,495,2394
BN-2014-3476090,65,-4,6,Office Supplies,Binders,69,69,-24
BN-2014-3476090,221,-15,2,Technology,Machines,236,236,-30
BN-2014-3491882,32,7,3,Office Supplies,Binders,25,25,21
BN-2014-3503687,43,-5,2,Office Supplies,Storage,48,48,-10
BN-2014-3503687,43,21,3,Office Supplies,Supplies,22,22,63
BN-2014-3503687,534,5,2,Technology,Machines,529,529,10
BN-2014-3515566,106,0,2,Technology,Phones,106,106,0
BN-2014-3518568,68,-56,2,Technology,Phones,124,124,-112
BN-2014-3536767,73,-31,1,Furniture,Bookcases,104,104,-31
BN-2014-3536767,10,-8,1,Office Supplies,Envelopes,18,18,-8
BN-2014-3536767,14,-3,2,Office Supplies,Fasteners,17,17,-6
BN-2014-3537667,78,-6,2,Furniture,Furnishings,84,84,-12
BN-2014-3537667,20,-18,2,Office Supplies,Storage,38,38,-36
BN-2014-3537667,19,-1,1,Office Supplies,Supplies,20,20,-1
BN-2014-3563498,539,-146,7,Furniture,Furnishings,685,685,-1022
BN-2014-3570494,22,-12,3,Office Supplies,Art,34,34,-36
BN-2014-3618473,208,-25,2,Office Supplies,Storage,233,233,-50
BN-2014-3622670,42,-15,12,Office Supplies,Labels,57,57,-180
BN-2014-3650547,212,-24,2,Furniture,Chairs,236,236,-48
BN-2014-3687942,1052,-82,3,Furniture,Bookcases,1134,1134,-246
BN-2014-3711552,47,-21,2,Technology,Machines,68,68,-42
BN-2014-3772513,8,-1,2,Office Supplies,Fasteners,9,9,-2
BN-2014-3819609,877,395,2,Furniture,Bookcases,482,482,790
BN-2014-3819609,141,10,4,Office Supplies,Supplies,131,131,40
BN-2014-3819609,224,58,3,Technology,Phones,166,166,174
BN-2014-3821323,132,-79,5,Furniture,Furnishings,211,211,-395
BN-2014-3821323,87,16,2,Office Supplies,Storage,71,71,32
BN-2014-3864024,670,15,5,Furniture,Bookcases,655,655,75
BN-2014-388260,44,-8,3,Office Supplies,Art,52,52,-24
BN-2014-388260,296,-225,11,Office Supplies,Storage,521,521,-2475
BN-2014-3913645,74,-51,3,Office Supplies,Art,125,125,-153
BN-2014-3913645,56,0,4,Office Supplies,Binders,56,56,0
BN-2014-3913645,373,-254,6,Technology,Copiers,627,627,-1524
BN-2014-3915044,503,-56,2,Office Supplies,Appliances,559,559,-112
BN-2014-3939059,11,-8,2,Office Supplies,Labels,19,19,-16
BN-2014-3939059,152,-129,6,Office Supplies,Storage,267,281,-774
BN-2014-3939293,482,-6,7,Technology,Machines,488,488,-42
BN-2014-3961366,58,-8,2,Office Supplies,Storage,66,66,-16
BN-2014-3985726,133,-56,2,Furniture,Chairs,189,189,-112
BN-2014-3985726,40,-37,3,Office Supplies,Art,77,77,-111
BN-2014-3985726,7,0,2,Office Supplies,Labels,7,7,0
BN-2014-3991888,148,-91,2,Technology,Phones,239,239,-182
BN-2014-3999779,1069,0,6,Office Supplies,Storage,1069,1069,0
BN-2014-4017957,72,-6,3,Office Supplies,Storage,78,78,-18
BN-2014-4060472,70,-14,2,Furniture,Furnishings,84,84,-28
BN-2014-4063586,187,-15,3,Office Supplies,Appliances,202,202,-45
BN-2014-4065808,15,-7,1,Office Supplies,Binders,22,22,-7
BN-2014-4065808,31,-7,5,Office Supplies,Labels,38,38,-35
BN-2014-409695,12,-2,3,Office Supplies,Binders,14,14,-6
BN-2014-409695,7,-1,2,Office Supplies,Labels,8,8,-2
BN-2014-4140795,30,-10,2,Office Supplies,Art,40,40,-20
BN-2014-4140795,23,-6,4,Office Supplies,Binders,29,29,-24
BN-2014-4140795,108,-19,3,Technology,Machines,127,127,-57
BN-2014-4149729,131,-154,8,Furniture,Furnishings,285,285,-1232
BN-2014-4149729,59,-48,9,Office Supplies,Art,21,107,-432
BN-2014-4240139,83,-81,3,Furniture,Chairs,164,164,-243
BN-2014-4309746,473,42,4,Furniture,Chairs,431,431,168
BN-2014-4309746,96,22,5,Office Supplies,Art,74,74,110
BN-2014-4309746,18,8,2,Office Supplies,Binders,10,10,16
BN-2014-4309746,187,30,4,Technology,Accessories,157,157,120
BN-2014-4354402,1145,-706,3,Technology,Phones,1851,1851,-2118
BN-2014-444620,322,-113,4,Office Supplies,Storage,435,435,-452
BN-2014-444620,1549,-439,4,Technology,Phones,1988,1988,-1756
BN-2014-4460556,771,-424,2,Technology,Phones,1195,1195,-848
BN-2014-4509327,1055,264,4,Technology,Copiers,791,791,1056
BN-2014-4513142,327,114,4,Office Supplies,Appliances,213,213,456
BN-2014-4519782,57,-48,6,Office Supplies,Fasteners,105,105,-288
BN-2014-4521538,490,-128,8,Furniture,Bookcases,618,618,-1024
BN-2014-45288,144,-7,4,Technology,Machines,151,151,-28
BN-2014-4538346,26,-5,2,Office Supplies,Art,31,31,-10
BN-2014-4554837,168,-51,2,Furniture,Bookcases,219,219,-102
BN-2014-4554837,23,-5,7,Office Supplies,Binders,28,28,-35
BN-2014-4587618,90,-44,11,Office Supplies,Art,56,134,-484
BN-2014-4587618,12,-7,2,Office Supplies,Fasteners,19,19,-14
BN-2014-4587618,76,-54,3,Technology,Machines,130,130,-162
BN-2014-4592650,191,51,5,Office Supplies,Supplies,140,140,255
BN-2014-4592650,149,-40,2,Technology,Phones,189,189,-80
BN-2014-4616231,29,-18,7,Office Supplies,Labels,47,47,-126
BN-2014-4619083,30,-35,1,Furniture,Chairs,65,65,-35
BN-2014-4627406,831,146,4,Furniture,Bookcases,256,685,584
BN-2014-4627406,29,10,2,Office Supplies,Art,19,19,20
BN-2014-4656521,55,-33,2,Furniture,Chairs,88,88,-66
BN-2014-47251,757,209,12,Office Supplies,Storage,58,548,2508
BN-2014-47251,90,17,3,Office Supplies,Supplies,73,73,51
BN-2014-4757131,340,20,7,Office Supplies,Supplies,320,320,140
BN-2014-4757131,416,137,3,Technology,Phones,279,279,411
BN-2014-4759297,158,-63,4,Furniture,Chairs,221,221,-252
BN-2014-4759297,11,-5,2,Office Supplies,Binders,16,16,-10
BN-2014-4787383,100,-58,4,Office Supplies,Binders,158,158,-232
BN-2014-4787383,193,-275,3,Technology,Phones,468,468,-825
BN-2014-4795126,41,-6,1,Furniture,Chairs,47,47,-6
BN-2014-4795126,832,-107,13,Furniture,Furnishings,254,939,-1391
BN-2014-4795126,10,-1,1,Office Supplies,Fasteners,11,11,-1
BN-2014-4795126,25,0,4,Office Supplies,Labels,25,25,0
BN-2014-4795126,66,-26,5,Office Supplies,Paper,71,92,-130
BN-2014-4805161,32,-8,2,Office Supplies,Art,40,40,-16
BN-2014-4805161,33,-12,7,Office Supplies,Storage,45,45,-84
BN-2014-4808235,81,-51,7,Office Supplies,Art,132,132,-357
BN-2014-4890231,709,-100,5,Technology,Phones,809,809,-500
BN-2014-4902106,191,13,8,Furniture,Furnishings,178,178,104
BN-2014-4912801,39,-17,5,Office Supplies,Art,42,56,-85
BN-2014-4920125,46,0,2,Technology,Machines,46,46,0
BN-2014-4964479,42,-23,2,Furniture,Furnishings,65,65,-46
BN-2014-4964479,17,-3,2,Office Supplies,Art,20,20,-6
BN-2014-4964479,263,-195,14,Office Supplies,Binders,37,458,-2730
BN-2014-4964479,22,-15,4,Office Supplies,Envelopes,37,37,-60
BN-2014-4964479,144,-72,8,Office Supplies,Storage,142,216,-576
BN-2014-4964479,186,-141,9,Office Supplies,Supplies,327,327,-1269
BN-2014-4964479,126,-63,3,Technology,Accessories,189,189,-189
BN-2014-4964479,102,0,3,Technology,Phones,102,102,0
BN-2014-4967786,306,-147,3,Office Supplies,Storage,453,453,-441
BN-2014-5013417,941,-203,3,Furniture,Tables,1144,1144,-609
BN-2014-5015566,424,-17,9,Furniture,Chairs,441,441,-153
BN-2014-5015566,31,-3,4,Office Supplies,Storage,34,34,-12
BN-2014-504974,98,-45,2,Furniture,Chairs,143,143,-90
BN-2014-504974,33,-12,5,Office Supplies,Binders,45,45,-60
BN-2014-504974,75,0,3,Office Supplies,Supplies,75,75,0
BN-2014-5088203,44,-32,3,Office Supplies,Art,76,76,-96
BN-2014-5088203,7,-3,2,Office Supplies,Binders,10,10,-6
BN-2014-5088203,10,-8,2,Office Supplies,Labels,18,18,-16
BN-2014-5088203,33,-29,3,Office Supplies,Supplies,62,62,-87
BN-2014-5117024,129,-75,5,Office Supplies,Supplies,204,204,-375
BN-2014-5182753,20,-22,1,Furniture,Furnishings,42,42,-22
BN-2014-5182753,49,-31,2,Office Supplies,Art,80,80,-62
BN-2014-5182753,34,-13,5,Office Supplies,Fasteners,47,47,-65
BN-2014-5182753,21,-5,1,Technology,Accessories,26,26,-5
BN-2014-5261213,7,-2,1,Office Supplies,Binders,9,9,-2
BN-2014-5261213,65,-16,2,Technology,Phones,81,81,-32
BN-2014-5301206,516,-392,8,Furniture,Chairs,908,908,-3136
BN-2014-5307129,27,-6,4,Office Supplies,Binders,33,33,-24
BN-2014-5307129,207,-153,3,Office Supplies,Storage,360,360,-459
BN-2014-5368093,115,-39,3,Office Supplies,Appliances,154,154,-117
BN-2014-5368093,87,-83,5,Office Supplies,Envelopes,170,170,-415
BN-2014-5409026,67,-42,3,Office Supplies,Art,109,109,-126
BN-2014-5409026,322,-193,5,Technology,Copiers,515,515,-965
BN-2014-5531507,4,-3,1,Office Supplies,Labels,7,7,-3
BN-2014-5531507,73,-7,1,Technology,Phones,80,80,-7
BN-2014-5536187,44,7,3,Office Supplies,Envelopes,37,37,21
BN-2014-5536187,168,-9,3,Office Supplies,Storage,177,177,-27
BN-2014-5536187,114,8,3,Technology,Accessories,106,106,24
BN-2014-5536187,1300,-16,8,Technology,Copiers,1316,1316,-128
BN-2014-5562074,275,-275,4,Office Supplies,Storage,550,550,-1100
BN-2014-5571092,887,80,3,Technology,Copiers,807,807,240
BN-2014-5575990,116,-4,1,Office Supplies,Storage,120,120,-4
BN-2014-5580925,167,43,7,Office Supplies,Paper,124,124,301
BN-2014-5580925,171,14,9,Office Supplies,Supplies,157,157,126
BN-2014-5580925,117,-6,3,Technology,Phones,123,123,-18
BN-2014-5614620,13,-13,2,Office Supplies,Labels,26,26,-26
BN-2014-5698928,82,-39,5,Office Supplies,Paper,121,121,-195
BN-2014-5698928,72,-49,1,Technology,Phones,121,121,-49
BN-2014-5780585,141,28,7,Furniture,Furnishings,113,113,196
BN-2014-5780585,76,-72,9,Office Supplies,Binders,148,148,-648
BN-2014-5780585,664,-332,12,Office Supplies,Storage,948,996,-3984
BN-2014-5780585,68,-30,1,Technology,Phones,98,98,-30
BN-2014-5799987,92,-34,6,Office Supplies,Art,100,126,-204
BN-2014-5801390,246,53,5,Office Supplies,Art,80,193,265
BN-2014-5801390,31,10,3,Office Supplies,Labels,21,21,30
BN-2014-5801390,714,56,4,Office Supplies,Storage,658,658,224
BN-2014-5824025,14,-1,4,Office Supplies,Envelopes,15,15,-4
BN-2014-5824025,352,-345,5,Office Supplies,Storage,697,697,-1725
BN-2014-5824025,469,-459,3,Technology,Machines,928,928,-1377
BN-2014-5849086,51,21,3,Office Supplies,Paper,30,30,63
BN-2014-5849086,387,-213,5,Office Supplies,Storage,600,600,-1065
BN-2014-585455,1829,-56,6,Furniture,Tables,1885,1885,-336
BN-2014-585455,17,6,1,Office Supplies,Art,11,11,6
BN-2014-585455,357,139,2,Office Supplies,Storage,218,218,278
BN-2014-5871078,332,-503,3,Technology,Copiers,835,835,-1509
BN-2014-5914359,381,-13,2,Office Supplies,Storage,394,394,-26
BN-2014-5918284,264,-30,3,Furniture,Furnishings,294,294,-90
BN-2014-5918284,45,-2,4,Office Supplies,Supplies,47,47,-8
BN-2014-5951909,134,42,2,Furniture,Chairs,92,92,84
BN-2014-5951909,51,7,2,Furniture,Furnishings,44,44,14
BN-2014-5951909,529,137,3,Technology,Phones,392,392,411
BN-2014-5960677,155,56,3,Furniture,Furnishings,99,99,168
BN-2014-5960677,148,52,5,Office Supplies,Art,96,96,260
BN-2014-5960677,86,-55,6,Office Supplies,Storage,141,141,-330
BN-2014-5985534,433,26,3,Technology,Copiers,407,407,78
BN-2014-5985534,245,-3,4,Technology,Phones,248,248,-12
BN-2014-6079376,1096,-658,7,Technology,Machines,1754,1754,-4606
BN-2014-6079376,545,-73,11,Technology,Phones,618,618,-803
BN-2014-6086541,243,-14,2,Furniture,Chairs,257,257,-28
BN-2014-6086541,1625,-77,3,Technology,Phones,1702,1702,-231
BN-2014-6091035,523,204,7,Office Supplies,Appliances,319,319,1428
BN-2014-6091035,44,-3,1,Office Supplies,Storage,47,47,-3
BN-2014-6157106,73,-25,3,Office Supplies,Storage,98,98,-75
BN-2014-6157106,68,-27,3,Technology,Accessories,95,95,-81
BN-2014-6163592,76,-50,1,Office Supplies,Storage,126,126,-50
BN-2014-6168100,27,-25,2,Office Supplies,Supplies,52,52,-50
BN-2014-6199887,7,-3,2,Office Supplies,Labels,10,10,-6
BN-2014-6199887,327,-39,1,Technology,Phones,366,366,-39
BN-2014-6221889,64,-7,3,Office Supplies,Storage,71,71,-21
BN-2014-6231386,20,-2,1,Technology,Accessories,22,22,-2
BN-2014-6245972,674,-187,2,Furniture,Tables,861,861,-374
BN-2014-6245972,111,42,7,Office Supplies,Supplies,26,69,294
BN-2014-6253845,1263,-56,5,Office Supplies,Appliances,1319,1319,-280
BN-2014-6319094,17,-12,5,Office Supplies,Labels,29,29,-60
BN-2014-6319094,929,-93,9,Office Supplies,Storage,1022,1022,-837
BN-2014-6319094,342,-103,4,Technology,Machines,445,445,-412
BN-2014-6330410,37,-5,3,Office Supplies,Paper,42,42,-15
BN-2014-6384429,16,-1,1,Office Supplies,Storage,17,17,-1
BN-2014-6460657,27,-15,1,Office Supplies,Art,42,42,-15
BN-2014-6460657,187,-141,10,Office Supplies,Storage,267,328,-1410
BN-2014-6460657,45,-2,4,Office Supplies,Supplies,47,47,-8
BN-2014-6469413,656,-36,2,Furniture,Bookcases,692,692,-72
BN-2014-6469413,832,0,3,Office Supplies,Appliances,832,832,0
BN-2014-6471690,516,69,4,Furniture,Bookcases,447,447,276
BN-2014-6471690,123,17,3,Furniture,Furnishings,106,106,51
BN-2014-6471690,610,-66,2,Furniture,Tables,676,676,-132
BN-2014-6471690,74,29,3,Office Supplies,Art,45,45,87
BN-2014-6471690,38,3,3,Office Supplies,Binders,23,35,9
BN-2014-6482721,41,6,5,Office Supplies,Labels,35,35,30
BN-2014-6482721,344,-34,3,Office Supplies,Storage,378,378,-102
BN-2014-6482721,1030,206,8,Technology,Copiers,824,824,1648
BN-2014-6549234,11,-2,4,Office Supplies,Binders,13,13,-8
BN-2014-6565146,166,-113,4,Technology,Accessories,279,279,-452
BN-2014-6565146,934,-916,7,Technology,Machines,1850,1850,-6412
BN-2014-6571686,83,-48,1,Furniture,Bookcases,131,131,-48
BN-2014-657443,258,-27,2,Technology,Phones,285,285,-54
BN-2014-6598534,294,138,2,Technology,Copiers,156,156,276
BN-2014-6598534,1229,-148,6,Technology,Phones,644,1377,-888
BN-2014-6632260,385,-77,11,Furniture,Furnishings,462,462,-847
BN-2014-6653003,482,-260,12,Furniture,Chairs,305,742,-3120
BN-2014-6653003,7,-1,2,Office Supplies,Binders,8,8,-2
BN-2014-6653003,24,-2,2,Office Supplies,Paper,26,26,-4
BN-2014-6653003,86,-21,1,Technology,Machines,107,107,-21
BN-2014-6657034,19,-15,3,Office Supplies,Binders,34,34,-45
BN-2014-6721665,175,81,9,Office Supplies,Paper,18,94,729
BN-2014-6721665,245,-78,3,Office Supplies,Storage,323,323,-234
BN-2014-6758663,288,-180,4,Furniture,Chairs,468,468,-720
BN-2014-6812331,332,-43,6,Technology,Phones,375,375,-258
BN-2014-6860245,32,-22,5,Office Supplies,Storage,54,54,-110
BN-2014-6883974,1021,-48,4,Technology,Machines,1069,1069,-192
BN-2014-6943244,13,-1,3,Office Supplies,Binders,14,14,-3
BN-2014-6943286,101,18,9,Office Supplies,Labels,83,83,162
BN-2014-6943286,1389,680,7,Office Supplies,Storage,709,709,4760
BN-2014-6943286,651,169,5,Technology,Copiers,482,482,845
BN-2014-6947599,56,18,2,Office Supplies,Binders,38,38,36
BN-2014-6947599,406,126,2,Office Supplies,Storage,280,280,252
BN-2014-6947599,624,37,2,Technology,Machines,587,587,74
BN-2014-6976303,30,2,3,Office Supplies,Binders,3,28,6
BN-2014-6988890,30,-5,5,Office Supplies,Art,35,35,-25
BN-2014-6988890,61,-23,2,Office Supplies,Storage,84,84,-46
BN-2014-7005725,74,23,8,Office Supplies,Labels,51,51,184
BN-2014-7005725,534,0,3,Office Supplies,Storage,534,534,0
BN-2014-7098171,6,-3,1,Office Supplies,Binders,9,9,-3
BN-2014-7135917,312,-312,7,Furniture,Chairs,624,624,-2184
BN-2014-7135917,9,-6,2,Office Supplies,Labels,15,15,-12
BN-2014-7160254,110,-68,4,Office Supplies,Storage,178,178,-272
BN-2014-7173798,97,-62,2,Office Supplies,Appliances,159,159,-124
BN-2014-7201366,396,-31,9,Office Supplies,Storage,427,427,-279
BN-2014-7211355,121,-17,3,Furniture,Furnishings,138,138,-51
BN-2014-7211355,51,-30,6,Office Supplies,Binders,70,81,-180
BN-2014-7233661,450,-90,3,Technology,Copiers,540,540,-270
BN-2014-7246636,122,-21,3,Furniture,Furnishings,143,143,-63
BN-2014-7246636,105,46,2,Office Supplies,Art,59,59,92
BN-2014-7262414,269,-86,2,Technology,Machines,355,355,-172
BN-2014-7281135,54,-3,3,Office Supplies,Storage,57,57,-9
BN-2014-7302833,229,-23,2,Office Supplies,Storage,252,252,-46
BN-2014-7312501,34,12,3,Office Supplies,Binders,22,22,36
BN-2014-7351644,227,102,8,Technology,Accessories,125,125,816
BN-2014-7358344,115,25,1,Technology,Accessories,90,90,25
BN-2014-7358344,668,-31,3,Technology,Copiers,699,699,-93
BN-2014-7374900,195,-117,5,Technology,Phones,312,312,-585
BN-2014-7375739,1327,318,8,Furniture,Chairs,1009,1009,2544
BN-2014-7390420,168,-10,3,Technology,Accessories,178,178,-30
BN-2014-7420129,427,-50,7,Technology,Phones,477,477,-350
BN-2014-7502802,28,-3,2,Office Supplies,Storage,31,31,-6
BN-2014-7539265,9,-6,2,Office Supplies,Binders,15,15,-12
BN-2014-7539265,1279,-640,8,Technology,Copiers,1919,1919,-5120
BN-2014-7571614,55,-19,7,Office Supplies,Fasteners,34,74,-133
BN-2014-7598465,206,-206,3,Office Supplies,Storage,412,412,-618
BN-2014-7621631,25,-2,5,Office Supplies,Binders,27,27,-10
BN-2014-7621631,174,-70,3,Technology,Accessories,244,244,-210
BN-2014-7634157,24,-21,7,Office Supplies,Labels,45,45,-147
BN-2014-7651755,457,-41,4,Office Supplies,Storage,498,498,-164
BN-2014-7867544,823,-18,7,Furniture,Chairs,841,841,-126
BN-2014-7867544,23,4,1,Office Supplies,Storage,19,19,4
BN-2014-7902691,172,-103,3,Furniture,Chairs,275,275,-309
BN-2014-7902691,49,3,1,Office Supplies,Supplies,46,46,3
BN-2014-8046775,200,-60,4,Furniture,Bookcases,260,260,-240
BN-2014-8046775,44,-8,3,Office Supplies,Art,52,52,-24
BN-2014-8046775,7,0,1,Office Supplies,Fasteners,7,7,0
BN-2014-8046775,11,-4,2,Office Supplies,Labels,15,15,-8
BN-2014-8046775,16,-10,2,Office Supplies,Paper,26,26,-20
BN-2014-8082943,269,111,3,Office Supplies,Appliances,158,158,333
BN-2014-8129561,238,20,2,Office Supplies,Storage,218,218,40
BN-2014-8129561,351,-47,8,Technology,Phones,398,398,-376
BN-2014-8266627,925,-447,5,Technology,Machines,1372,1372,-2235
BN-2014-8322857,28,-26,2,Office Supplies,Art,54,54,-52
BN-2014-8322857,512,-225,5,Office Supplies,Storage,737,737,-1125
BN-2014-8330750,31,-2,2,Office Supplies,Storage,33,33,-4
BN-2014-8340437,211,-105,2,Office Supplies,Storage,316,316,-210
BN-2014-8354693,27,-25,2,Office Supplies,Art,52,52,-50
BN-2014-8354693,245,-78,2,Technology,Copiers,323,323,-156
BN-2014-839820,30,13,1,Office Supplies,Paper,17,17,13
BN-2014-839820,185,-67,8,Office Supplies,Storage,81,252,-536
BN-2014-8403814,62,-14,6,Office Supplies,Storage,28,76,-84
BN-2014-8403814,100,-23,1,Technology,Phones,123,123,-23
BN-2014-8433549,183,-66,5,Technology,Phones,249,249,-330
BN-2014-8459769,133,-42,1,Technology,Copiers,175,175,-42
BN-2014-848843,86,0,4,Office Supplies,Paper,86,86,0
BN-2014-8493925,76,-92,8,Furniture,Furnishings,168,168,-736
BN-2014-8493925,273,-87,4,Technology,Phones,360,360,-348
BN-2014-8501685,50,-44,2,Office Supplies,Binders,94,94,-88
BN-2014-8501685,37,-23,4,Office Supplies,Supplies,60,60,-92
BN-2014-8501685,299,-70,3,Technology,Machines,326,369,-210
BN-2014-8509634,1061,-36,8,Furniture,Bookcases,1097,1097,-288
BN-2014-8625232,22,-6,1,Furniture,Furnishings,28,28,-6
BN-2014-8625232,434,26,11,Office Supplies,Supplies,408,408,286
BN-2014-863446,122,-47,4,Office Supplies,Storage,169,169,-188
BN-2014-8656062,314,-239,13,Office Supplies,Binders,553,553,-3107
BN-2014-8679573,68,-62,2,Office Supplies,Appliances,130,130,-124
BN-2014-8685864,1629,-153,3,Technology,Phones,1782,1782,-459
BN-2014-8703611,880,97,8,Furniture,Furnishings,783,783,776
BN-2014-8703611,154,39,3,Office Supplies,Binders,115,115,117
BN-2014-8703611,816,-96,3,Technology,Copiers,912,912,-288
BN-2014-8706715,182,-11,3,Furniture,Bookcases,193,193,-33
BN-2014-8729433,389,-83,3,Furniture,Chairs,472,472,-249
BN-2014-8729433,40,16,3,Office Supplies,Binders,24,24,48
BN-2014-8729433,23,2,2,Office Supplies,Labels,21,21,4
BN-2014-8729433,1019,143,8,Office Supplies,Storage,352,876,1144
BN-2014-8729433,117,14,3,Office Supplies,Supplies,103,103,42
BN-2014-8744375,496,-79,2,Office Supplies,Appliances,575,575,-158
BN-2014-8834829,711,-8,4,Office Supplies,Storage,719,719,-32
BN-2014-8840192,89,-89,2,Furniture,Furnishings,178,178,-178
BN-2014-8840192,19,-2,2,Office Supplies,Fasteners,21,21,-4
BN-2014-8840192,249,-130,4,Technology,Phones,379,379,-520
BN-2014-8847537,42,-26,2,Office Supplies,Envelopes,68,68,-52
BN-2014-8871614,40,-7,3,Office Supplies,Art,47,47,-21
BN-2014-8871614,34,-22,4,Office Supplies,Paper,56,56,-88
BN-2014-8911899,143,-129,2,Technology,Phones,272,272,-258
BN-2014-8933251,114,-39,5,Office Supplies,Envelopes,153,153,-195
BN-2014-8981319,35,-8,2,Furniture,Furnishings,43,43,-16
BN-2014-8981319,1560,421,3,Office Supplies,Appliances,1139,1139,1263
BN-2014-8981319,133,12,5,Office Supplies,Art,121,121,60
BN-2014-9079543,45,13,4,Office Supplies,Labels,32,32,52
BN-2014-9079543,24,-9,4,Office Supplies,Storage,33,33,-36
BN-2014-91476,55,-39,4,Office Supplies,Art,94,94,-156
BN-2014-9212655,1103,-276,3,Furniture,Chairs,1379,1379,-828
BN-2014-9235525,105,20,2,Office Supplies,Art,85,85,40
BN-2014-9235525,123,41,5,Office Supplies,Binders,14,82,205
BN-2014-9235525,59,30,3,Office Supplies,Fasteners,29,29,90
BN-2014-9235525,635,-349,5,Office Supplies,Storage,984,984,-1745
BN-2014-9235525,46,-14,1,Technology,Phones,60,60,-14
BN-2014-9255621,211,70,7,Office Supplies,Art,52,141,490
BN-2014-9255621,149,-87,4,Office Supplies,Storage,236,236,-348
BN-2014-9257992,534,0,3,Office Supplies,Storage,534,534,0
BN-2014-9271210,362,127,1,Furniture,Bookcases,235,235,127
BN-2014-9271210,12,0,2,Office Supplies,Binders,12,12,0
BN-2014-9271210,353,90,8,Office Supplies,Storage,263,263,720
BN-2014-9271210,193,46,1,Technology,Copiers,147,147,46
BN-2014-9271210,461,53,8,Technology,Machines,243,408,424
BN-2014-9271210,333,-15,3,Technology,Phones,348,348,-45
BN-2014-9289926,116,-56,5,Office Supplies,Art,172,172,-280
BN-2014-9289926,36,-4,6,Office Supplies,Binders,24,40,-24
BN-2014-9289926,305,-270,5,Technology,Machines,575,575,-1350
BN-2014-9297622,110,32,10,Office Supplies,Binders,48,78,320
BN-2014-9300857,494,54,4,Furniture,Bookcases,440,440,216
BN-2014-9300857,98,-12,2,Technology,Machines,110,110,-24
BN-2014-9322996,1603,0,9,Office Supplies,Storage,1603,1603,0
BN-2014-9473306,259,-55,2,Furniture,Chairs,314,314,-110
BN-2014-9478365,160,-59,2,Office Supplies,Storage,219,219,-118
BN-2014-9493182,30,-5,2,Furniture,Furnishings,35,35,-10
BN-2014-9526659,43,0,3,Office Supplies,Storage,43,43,0
BN-2014-9564073,781,-594,6,Technology,Copiers,1375,1375,-3564
BN-2014-9608893,68,-55,5,Technology,Accessories,123,123,-275
BN-2014-9612123,107,-54,4,Office Supplies,Art,161,161,-216
BN-2014-9635866,1076,-38,4,Technology,Copiers,1114,1114,-152
BN-2014-9643770,25,-5,4,Office Supplies,Storage,30,30,-20
BN-2014-9660071,856,385,6,Technology,Copiers,471,471,2310
BN-2014-9660071,485,29,4,Technology,Machines,456,456,116
BN-2014-9778057,476,0,3,Furniture,Chairs,476,476,0
BN-2014-9778057,257,23,5,Office Supplies,Binders,234,234,115
BN-2014-9861831,1364,-1864,5,Furniture,Tables,3228,3228,-9320
BN-2014-9900559,50,15,4,Office Supplies,Fasteners,35,35,60
BN-2014-9936235,180,5,3,Office Supplies,Appliances,175,175,15
BN-2014-9936235,223,52,10,Office Supplies,Art,100,171,520
BN-2014-9936235,12,1,2,Office Supplies,Binders,11,11,2
BN-2014-9936235,38,18,1,Office Supplies,Envelopes,20,20,18
BN-2014-9936235,65,17,2,Office Supplies,Paper,48,48,34
BN-2014-9936235,232,5,16,Office Supplies,Storage,152,227,80
BN-2014-9936235,87,4,2,Office Supplies,Supplies,83,83,8
BN-2014-9956190,193,-166,3,Office Supplies,Storage,359,359,-498
BN-2014-9956954,24,-30,1,Furniture,Chairs,54,54,-30
BN-2014-9978138,1355,-60,5,Office Supplies,Appliances,1415,1415,-300
BN-2014-9982544,680,207,11,Office Supplies,Storage,349,473,2277
BN-2014-9995192,2617,1151,4,Technology,Phones,1466,1466,4604
BN-2014-9998478,1275,-1148,7,Furniture,Bookcases,2423,2423,-8036
BN-2014-9998478,66,-12,5,Office Supplies,Art,78,78,-60
BN-2014-9998478,8,-2,3,Office Supplies,Binders,10,10,-6
BN-2014-9998478,80,-56,4,Technology,Machines,136,136,-224
BN-2014-9998478,592,-383,7,Technology,Phones,279,975,-2681
